,date,firm,Ticker,Research Development,Income Before Tax,netIncome,Selling General Administrative,netProfitMargin,Ebit,Operating Income,Interest Expense,Income Tax Expense,revenue,Total Operating Expenses,Cost Of Revenue,Total Other Income Expense Net,Net Income From Continuing Ops,Net Income Applicable To Common Shares
0,2021-09-30,3M,MMM,482000000,1761000000,1434000000,1739000000,4089000000,1868000000,1868000000,-117000000,324000000,8942000000,7074000000,4853000000,-107000000,1437000000,1434000000
1,2021-06-30,3M,MMM,514000000,1940000000,1524000000,1666000000,4231000000,2051000000,2051000000,-121000000,415000000,8950000000,6899000000,4719000000,-111000000,1525000000,1524000000
2,2021-03-31,3M,MMM,520000000,1946000000,1624000000,1720000000,4327000000,2087000000,2087000000,-132000000,319000000,8851000000,6764000000,4524000000,-141000000,1627000000,1624000000
3,2020-12-31,3M,MMM,449000000,1706000000,1389000000,1814000000,4246000000,1983000000,1983000000,-141000000,316000000,8583000000,6600000000,4337000000,-277000000,1390000000,1389000000
4,2021-09-30,3M,MMM,482000000,1761000000,1434000000,1739000000,4089000000,1868000000,1868000000,-117000000,324000000,8942000000,7074000000,4853000000,-107000000,1437000000,1434000000
5,2021-06-30,3M,MMM,514000000,1940000000,1524000000,1666000000,4231000000,2051000000,2051000000,-121000000,415000000,8950000000,6899000000,4719000000,-111000000,1525000000,1524000000
6,2021-03-31,3M,MMM,520000000,1946000000,1624000000,1720000000,4327000000,2087000000,2087000000,-132000000,319000000,8851000000,6764000000,4524000000,-141000000,1627000000,1624000000
7,2020-12-31,3M,MMM,449000000,1706000000,1389000000,1814000000,4246000000,1983000000,1983000000,-141000000,316000000,8583000000,6600000000,4337000000,-277000000,1390000000,1389000000
8,2021-09-30,A. O. Smith,AOS,,166400000,131600000,174300000,340300000,166000000,166000000,-1000000,34800000,914600000,748600000,574300000,400000,131600000,131600000
9,2021-06-30,A. O. Smith,AOS,,151300000,118200000,169800000,321400000,151600000,151600000,-900000,33100000,859800000,708200000,538400000,-300000,118200000,118200000
10,2021-03-31,A. O. Smith,AOS,,126100000,97700000,166500000,288600000,122100000,122100000,-1000000,28400000,769000000,646900000,480400000,4000000,97700000,97700000
11,2020-12-31,A. O. Smith,AOS,,151900000,120000000,184700000,324100000,139400000,139400000,-1000000,31900000,834500000,695100000,510400000,12500000,120000000,120000000
12,2021-09-30,Abbott Laboratories,ABT,672000000,2493000000,2100000000,2699000000,6505000000,2614000000,2614000000,-133000000,393000000,10928000000,8314000000,4423000000,-121000000,2100000000,2092000000
13,2021-06-30,Abbott Laboratories,ABT,654000000,1348000000,1189000000,2658000000,5786000000,1970000000,1970000000,-134000000,159000000,10223000000,8253000000,4437000000,-622000000,1189000000,1184000000
14,2021-03-31,Abbott Laboratories,ABT,654000000,2043000000,1793000000,2716000000,6056000000,2177000000,2177000000,-135000000,250000000,10456000000,8279000000,4400000000,-134000000,1793000000,1785000000
15,2020-12-31,Abbott Laboratories,ABT,643000000,2388000000,2162000000,2525000000,6207000000,2531000000,2531000000,-136000000,230000000,10701000000,8170000000,4494000000,-143000000,2158000000,2151000000
16,2021-09-30,AbbVie,ABBV,1655000000,3688000000,3179000000,2946000000,9998000000,4897000000,4897000000,-596000000,508000000,14342000000,9445000000,4344000000,-1209000000,3180000000,3158000000
17,2021-06-30,AbbVie,ABBV,1784000000,1163000000,766000000,3049000000,9461000000,4696000000,4696000000,-615000000,394000000,13959000000,9263000000,4498000000,-3533000000,769000000,751000000
18,2021-03-31,AbbVie,ABBV,1731000000,3867000000,3553000000,2741000000,8818000000,4346000000,4346000000,-632000000,312000000,13010000000,8664000000,4192000000,-479000000,3555000000,3536000000
19,2020-12-31,AbbVie,ABBV,1821000000,-1507000000,36000000,3099000000,10448000000,5528000000,5528000000,-629000000,-1545000000,13858000000,8330000000,3410000000,-7035000000,38000000,20000000
20,2021-09-30,Abiomed,ABMD,41041000,67271000,56953000,102779000,204256000,60436000,60436000,,10318000,248142000,187706000,43886000,6835000,56953000,56953000
21,2021-06-30,Abiomed,ABMD,36837000,-9350000,-26525000,103484000,207397000,67076000,67076000,,17175000,252585000,185509000,45188000,-76426000,-26525000,-26525000
22,2021-03-31,Abiomed,ABMD,32599000,73494000,56856000,100374000,195167000,62194000,62194000,,16638000,241245000,179051000,46078000,11300000,56856000,56856000
23,2020-12-31,Abiomed,ABMD,32105000,80735000,61868000,86198000,190553000,72250000,72250000,,18867000,231663000,159413000,41110000,8485000,61868000,61868000
24,2021-08-31,Accenture,ACN,,1917805000,1416248000,2507527000,4466216000,1958689000,1958689000,-12977000,480382000,13419284000,11460595000,8953068000,-40884000,1437423000,1416248000
25,2021-05-31,Accenture,ACN,,2094001000,1549426000,2285728000,4404384000,2118656000,2118656000,-28739000,524429000,13263795000,11145139000,8859411000,-24655000,1569572000,1549426000
26,2021-02-28,Accenture,ACN,,1762443000,1440859000,1941717000,3595232000,1653515000,1653515000,-8922000,300950000,12088125000,10434610000,8492893000,108928000,1461493000,1440859000
27,2020-11-30,Accenture,ACN,,1986867000,1500276000,2007627000,3898296000,1890669000,1890669000,-8854000,464810000,11762185000,9871516000,7863889000,96198000,1522057000,1500276000
28,2021-09-30,Activision Blizzard,ATVI,329000000,759000000,639000000,387000000,1543000000,827000000,827000000,-27000000,120000000,2070000000,1243000000,527000000,-68000000,639000000,639000000
29,2021-06-30,Activision Blizzard,ATVI,335000000,1002000000,876000000,434000000,1741000000,972000000,972000000,-27000000,126000000,2296000000,1324000000,555000000,30000000,876000000,876000000
30,2021-03-31,Activision Blizzard,ATVI,353000000,765000000,619000000,519000000,1697000000,825000000,825000000,-28000000,146000000,2275000000,1450000000,578000000,-60000000,619000000,619000000
31,2020-12-31,Activision Blizzard,ATVI,348000000,563000000,509000000,597000000,1595000000,650000000,650000000,-27000000,54000000,2412000000,1762000000,817000000,-87000000,509000000,509000000
32,2021-09-30,ADM,ADM,,653000000,526000000,716000000,1326000000,607000000,607000000,-61000000,120000000,20340000000,19733000000,19014000000,46000000,533000000,526000000
33,2021-06-30,ADM,ADM,,825000000,712000000,815000000,1463000000,642000000,642000000,-40000000,113000000,22926000000,22284000000,21463000000,183000000,712000000,712000000
34,2021-03-31,ADM,ADM,,824000000,689000000,697000000,1548000000,843000000,843000000,-87000000,131000000,18893000000,18050000000,17345000000,-19000000,693000000,689000000
35,2020-12-31,ADM,ADM,,756000000,687000000,720000000,1352000000,615000000,615000000,-69000000,63000000,17978000000,17363000000,16626000000,141000000,693000000,687000000
36,2021-09-03,Adobe,ADBE,651000000,1418000000,1212000000,1333000000,3468000000,1441000000,1441000000,-27000000,206000000,3935000000,2494000000,467000000,-23000000,1212000000,1212000000
37,2021-06-04,Adobe,ADBE,612000000,1386000000,1116000000,1329000000,3391000000,1406000000,1406000000,-28000000,270000000,3835000000,2429000000,444000000,-20000000,1116000000,1116000000
38,2021-03-05,Adobe,ADBE,620000000,1433000000,1261000000,1339000000,3458000000,1454000000,1454000000,-30000000,172000000,3905000000,2451000000,447000000,-21000000,1261000000,1261000000
39,2020-11-27,Adobe,ADBE,558000000,1197000000,2250000000,1184000000,2996000000,1215000000,1215000000,-27000000,-1053000000,3424000000,2209000000,428000000,-18000000,2250000000,2250000000
40,2021-07-17,Advance Auto Parts,AAP,,237765000,178696000,932793000,1189416000,256623000,256623000,-8306000,59069000,2649415000,2392792000,1459999000,-18858000,178696000,178696000
41,2021-07-17,Advance Auto Parts,AAP,,237765000,178696000,932793000,1189416000,256623000,256623000,-8306000,0,2649415000,0,0,0,178696000,178696000
42,2021-04-24,Advance Auto Parts,AAP,,245774000,185930000,1200138000,1487229000,287091000,287091000,-11191000,59844000,3330370000,3043279000,1843141000,-41317000,185930000,185930000
43,2021-04-17,Advance Auto Parts,AAP,,245774000,182313000,1200138000,1338322500,271856500,287091000,-9748500,0,2989892500,0,0,0,185930000,185930000
44,2021-09-25,Advanced Micro Devices,AMD,765000000,1005000000,923000000,368000000,2086000000,956000000,956000000,-7000000,82000000,4313000000,3357000000,2227000000,49000000,923000000,923000000
45,2021-06-26,Advanced Micro Devices,AMD,659000000,823000000,710000000,331000000,1830000000,841000000,841000000,-10000000,113000000,3850000000,3009000000,2020000000,-18000000,710000000,710000000
46,2021-03-27,Advanced Micro Devices,AMD,610000000,644000000,555000000,304000000,1587000000,677000000,677000000,-9000000,89000000,3445000000,2768000000,1858000000,-33000000,555000000,555000000
47,2020-12-26,Advanced Micro Devices,AMD,573000000,549000000,1781000000,308000000,1451000000,570000000,570000000,-9000000,-1232000000,3244000000,2674000000,1793000000,-21000000,1781000000,1781000000
48,2021-09-30,AES Corp,AES,,611000000,343000000,39000000,760000000,721000000,721000000,-242000000,126000000,3036000000,2315000000,2276000000,-110000000,485000000,343000000
49,2021-06-30,AES Corp,AES,,-140000000,28000000,45000000,728000000,683000000,683000000,-237000000,-59000000,2700000000,2017000000,1972000000,-823000000,-81000000,28000000
50,2021-03-31,AES Corp,AES,,-21000000,-148000000,46000000,664000000,618000000,618000000,-190000000,8000000,2635000000,2017000000,1971000000,-639000000,-29000000,-148000000
51,2020-12-31,AES Corp,AES,,562000000,318000000,47000000,724000000,677000000,677000000,-297000000,161000000,2560000000,1883000000,1836000000,-115000000,401000000,318000000
52,2021-09-30,Aflac,AFL,,1113000000,888000000,869000000,2039000000,1170000000,1170000000,-57000000,225000000,5237000000,4067000000,3198000000,-57000000,888000000,888000000
53,2021-06-30,Aflac,AFL,,1373000000,1105000000,881000000,2316000000,1435000000,1435000000,-62000000,268000000,5564000000,4129000000,3248000000,-62000000,1105000000,1105000000
54,2021-03-31,Aflac,AFL,,1603000000,1293000000,832000000,2497000000,1665000000,1665000000,-62000000,310000000,5869000000,4204000000,3372000000,-62000000,1293000000,1293000000
55,2020-12-31,Aflac,AFL,,1217000000,952000000,1038000000,2316000000,1278000000,1278000000,-61000000,265000000,5913000000,4635000000,3597000000,-61000000,952000000,952000000
56,2021-07-31,Agilent Technologies,A,113000000,327000000,264000000,390000000,852000000,349000000,349000000,-21000000,63000000,1586000000,1237000000,734000000,-22000000,264000000,264000000
57,2021-04-30,Agilent Technologies,A,109000000,273000000,216000000,420000000,817000000,288000000,288000000,-20000000,57000000,1525000000,1237000000,708000000,-15000000,216000000,216000000
58,2021-01-31,Agilent Technologies,A,103000000,312000000,288000000,398000000,838000000,337000000,337000000,-19000000,24000000,1548000000,1211000000,710000000,-25000000,288000000,288000000
59,2020-10-31,Agilent Technologies,A,102000000,283000000,222000000,342000000,788000000,344000000,344000000,-19000000,61000000,1483000000,1139000000,695000000,-61000000,222000000,222000000
60,2021-09-30,Air Products & Chemicals,APD,25700000,692300000,610400000,202100000,834800000,616700000,616700000,-33400000,125300000,2841100000,2224400000,2006300000,75600000,567000000,610400000
61,2021-06-30,Air Products & Chemicals,APD,23200000,625800000,533600000,192600000,802800000,598400000,598400000,-35600000,101700000,2604700000,2006300000,1801900000,27400000,524100000,533600000
62,2021-03-31,Air Products & Chemicals,APD,21100000,599000000,473100000,189100000,756500000,555800000,555800000,-36100000,121900000,2502000000,1946200000,1745500000,43200000,477100000,473100000
63,2020-12-31,Air Products & Chemicals,APD,23500000,590300000,482000000,182100000,742800000,562500000,562500000,-36700000,113900000,2375200000,1812700000,1632400000,27800000,476400000,482000000
64,2021-09-30,Akamai Technologies,AKAM,82899000,192564000,178916000,241463000,543467000,207146000,207146000,-18144000,13648000,860333000,653187000,316866000,-14582000,178916000,178916000
65,2021-06-30,Akamai Technologies,AKAM,77255000,174506000,156497000,246049000,532824000,197460000,197460000,-18037000,18009000,852824000,655364000,320000000,-22954000,156497000,156497000
66,2021-03-31,Akamai Technologies,AKAM,82045000,167593000,155695000,253005000,536021000,189544000,189544000,-17834000,11898000,842708000,653164000,306687000,-21951000,155695000,155695000
67,2020-12-31,Akamai Technologies,AKAM,67228000,117528000,113370000,298739000,542440000,165579000,165579000,-17342000,4158000,846287000,680708000,303847000,-48051000,113370000,113370000
68,2021-09-30,Alaska Air Group,ALB,13289000,-489103000,-392781000,95699000,249273000,140285000,140285000,-5136000,-114670000,830566000,690281000,581293000,-629388000,-374433000,-392781000
69,2021-06-30,Alaska Air Group,ALB,13976000,553193000,424600000,113393000,248417000,121048000,121048000,-5952000,106985000,773896000,652848000,525479000,432145000,446208000,424600000
70,2021-03-31,Alaska Air Group,ALB,14636000,139805000,95677000,85589000,263687000,163462000,163462000,-16084000,22107000,829291000,665829000,565604000,-23657000,117698000,95677000
71,2020-12-31,Alaska Air Group,ALB,15375000,92076000,84635000,115008000,266720000,136337000,136337000,-19152000,-10101000,879147000,742810000,612427000,-44261000,102177000,84635000
72,2021-09-30,Albemarle Corporation,ALK,,245000000,194000000,49000000,562000000,257000000,257000000,-27000000,51000000,1953000000,1696000000,1391000000,-12000000,194000000,194000000
73,2021-06-30,Albemarle Corporation,ALK,,528000000,397000000,41000000,246000000,-36000000,-36000000,-36000000,131000000,1527000000,1563000000,1281000000,564000000,397000000,397000000
74,2021-03-31,Albemarle Corporation,ALK,,-173000000,-131000000,33000000,-312000000,-573000000,-573000000,-29000000,-42000000,797000000,1370000000,1109000000,400000000,-131000000,-131000000
75,2020-12-31,Albemarle Corporation,ALK,,-643000000,-447000000,18000000,-213000000,-449000000,-449000000,-31000000,-196000000,808000000,1257000000,1021000000,-194000000,-447000000,-447000000
76,2021-09-30,Alexandria Real Estate Equities,ARE,,124433000,103147000,37931000,384855000,136082000,136082000,-35678000,0,550850000,414768000,165995000,-11649000,124433000,101264000
77,2021-06-30,Alexandria Real Estate Equities,ARE,,404520000,385084000,37880000,368273000,140341000,140341000,-35158000,0,512228000,371887000,143955000,264179000,404520000,380563000
78,2021-03-31,Alexandria Real Estate Equities,ARE,,25533000,8121000,33996000,345498000,130589000,130589000,-36467000,0,483386000,352797000,137888000,-105056000,25533000,7979000
79,2020-12-31,Alexandria Real Estate Equities,ARE,,457133000,441484000,32690000,330546000,120106000,120106000,-37538000,0,467313000,347207000,136767000,337027000,457133000,436620000
80,2021-09-30,Align Technology,ALGN,65587000,261988000,180969000,428409000,755156000,261160000,261160000,,81019000,1015906000,754746000,260750000,828000,180969000,180969000
81,2021-06-30,Align Technology,ALGN,57715000,268802000,199714000,431921000,758538000,268902000,268902000,,69088000,1010808000,741906000,252270000,-100000,199714000,199714000
82,2021-03-31,Align Technology,ALGN,54537000,261621000,200376000,397115000,677098000,225446000,225446000,,61245000,894771000,669325000,217673000,36175000,200376000,200376000
83,2020-12-31,Align Technology,ALGN,48887000,214542000,158988000,348392000,610463000,213184000,213184000,,55554000,834520000,621336000,224057000,1358000,158988000,158988000
84,2021-09-30,Allegion,ALLE,,140800000,143500000,160000000,300500000,140500000,140500000,-12300000,-2800000,717000000,576500000,416500000,300000,143600000,143500000
85,2021-06-30,Allegion,ALLE,,136200000,118700000,173100000,320500000,147400000,147400000,-12400000,17400000,746900000,599500000,426400000,-11200000,118800000,118700000
86,2021-03-31,Allegion,ALLE,,122500000,108000000,164200000,297400000,133200000,133200000,-12300000,14300000,694300000,561100000,396900000,-10700000,108200000,108000000
87,2020-12-31,Allegion,ALLE,,105800000,93300000,156600000,320700000,164100000,164100000,-12300000,12400000,727300000,563200000,406600000,-58300000,93400000,93300000
88,2021-09-30,Alliant Energy,LNT,,235000000,256000000,,480000000,289000000,289000000,-71000000,-21000000,1024000000,735000000,544000000,-54000000,256000000,256000000
89,2021-06-30,Alliant Energy,LNT,,127000000,144000000,,367000000,176000000,176000000,-71000000,-17000000,817000000,641000000,450000000,-49000000,144000000,144000000
90,2021-03-31,Alliant Energy,LNT,,143000000,171000000,,388000000,198000000,198000000,-72000000,-28000000,901000000,703000000,513000000,-55000000,171000000,171000000
91,2020-12-31,Alliant Energy,LNT,,54000000,64000000,24000000,299000000,88000000,88000000,-70000000,-10000000,817000000,729000000,518000000,-34000000,64000000,64000000
92,2021-09-30,Allstate Corp,ALL,,226000000,538000000,1930000000,2357000000,318000000,318000000,-69000000,20000000,12480000000,12162000000,10123000000,-92000000,206000000,508000000
93,2021-06-30,Allstate Corp,ALL,,1797000000,1625000000,1549000000,3642000000,1988000000,1988000000,-91000000,362000000,12646000000,10658000000,9004000000,-191000000,1435000000,1595000000
94,2021-03-31,Allstate Corp,ALL,,3032000000,-1381000000,1399000000,4643000000,3191000000,3191000000,-86000000,626000000,12451000000,9260000000,7808000000,-159000000,2406000000,-1408000000
95,2020-12-31,Allstate Corp,ALL,,3310000000,2624000000,1131000000,4590000000,3429000000,3429000000,-80000000,686000000,12018000000,8589000000,7428000000,-119000000,2624000000,2598000000
96,2021-06-30,Alphabet (Class A),GOOGL,7675000000,21985000000,18525000000,8617000000,35653000000,19361000000,19361000000,-76000000,3460000000,61880000000,42519000000,26227000000,2624000000,18525000000,18525000000
97,2021-03-31,Alphabet (Class A),GOOGL,7485000000,21283000000,17930000000,7289000000,31211000000,16437000000,16437000000,-76000000,3353000000,55314000000,38877000000,24103000000,4846000000,17930000000,17930000000
98,2020-12-31,Alphabet (Class A),GOOGL,7022000000,18689000000,15227000000,8145000000,30818000000,15651000000,15651000000,-53000000,3462000000,56898000000,41247000000,26080000000,3038000000,15227000000,15227000000
99,2020-09-30,Alphabet (Class A),GOOGL,6856000000,13359000000,11247000000,6987000000,25056000000,11213000000,11213000000,-48000000,2112000000,46173000000,34960000000,21117000000,2146000000,11247000000,11247000000
100,2021-06-30,Alphabet (Class C),GOOG,7675000000,21985000000,18525000000,8617000000,35653000000,19361000000,19361000000,-76000000,3460000000,61880000000,42519000000,26227000000,2624000000,18525000000,18525000000
101,2021-03-31,Alphabet (Class C),GOOG,7485000000,21283000000,17930000000,7289000000,31211000000,16437000000,16437000000,-76000000,3353000000,55314000000,38877000000,24103000000,4846000000,17930000000,17930000000
102,2020-12-31,Alphabet (Class C),GOOG,7022000000,18689000000,15227000000,8145000000,30818000000,15651000000,15651000000,-53000000,3462000000,56898000000,41247000000,26080000000,3038000000,15227000000,15227000000
103,2020-09-30,Alphabet (Class C),GOOG,6856000000,13359000000,11247000000,6987000000,25056000000,11213000000,11213000000,-48000000,2112000000,46173000000,34960000000,21117000000,2146000000,11247000000,11247000000
104,2021-06-30,Altria Group,MO,,2909000000,2149000000,492000000,3732000000,3240000000,3240000000,-297000000,759000000,5614000000,2374000000,1882000000,-331000000,2150000000,2146000000
105,2021-03-31,Altria Group,MO,,1937000000,1424000000,467000000,3273000000,2806000000,2806000000,-313000000,516000000,4880000000,2074000000,1607000000,-869000000,1421000000,1421000000
106,2020-12-31,Altria Group,MO,,2541000000,1924000000,434000000,3166000000,2732000000,2732000000,-336000000,619000000,5055000000,2323000000,1889000000,-191000000,1922000000,1922000000
107,2020-09-30,Altria Group,MO,,-324000000,-952000000,520000000,3718000000,3198000000,3198000000,-318000000,632000000,5678000000,2480000000,1960000000,-3522000000,-956000000,-953000000
108,2021-06-30,Amazon,AMZN,11794000000,8646000000,7778000000,29397000000,48904000000,7702000000,7702000000,-435000000,868000000,113080000000,105378000000,64176000000,944000000,7778000000,7778000000
109,2021-03-31,Amazon,AMZN,10584000000,10263000000,8107000000,26628000000,46115000000,8865000000,8865000000,-399000000,2156000000,108518000000,99653000000,62403000000,1398000000,8107000000,8107000000
110,2020-12-31,Amazon,AMZN,16466000000,7787000000,7222000000,23428000000,46271000000,6873000000,6873000000,-414000000,565000000,125555000000,118682000000,79284000000,914000000,7222000000,7222000000
111,2020-09-30,Amazon,AMZN,9334000000,6900000000,6331000000,23449000000,39039000000,6194000000,6194000000,-428000000,569000000,96145000000,89951000000,57106000000,706000000,6331000000,6331000000
112,2021-06-30,Amcor,AMCR,26000000,333000000,255000000,327000000,745000000,456000000,456000000,-40000000,74000000,3454000000,2998000000,2709000000,-123000000,259000000,254000000
113,2021-03-31,Amcor,AMCR,25000000,341000000,267000000,321000000,682000000,350000000,350000000,-36000000,71000000,3207000000,2857000000,2525000000,-9000000,270000000,267000000
114,2020-12-31,Amcor,AMCR,23000000,277000000,219000000,305000000,651000000,327000000,327000000,-37000000,55000000,3103000000,2776000000,2452000000,-50000000,222000000,219000000
115,2020-09-30,Amcor,AMCR,26000000,261000000,198000000,326000000,654000000,305000000,305000000,-44000000,61000000,3097000000,2792000000,2443000000,-44000000,200000000,198000000
116,2021-06-30,Ameren Corp,AEE,,239000000,207000000,-34000000,693000000,320000000,320000000,-96000000,31000000,1410000000,1090000000,717000000,-81000000,208000000,207000000
117,2021-03-31,Ameren Corp,AEE,,262000000,233000000,-34000000,725000000,350000000,350000000,-100000000,27000000,1496000000,1146000000,771000000,-88000000,235000000,233000000
118,2020-12-31,Ameren Corp,AEE,,137000000,115000000,-31000000,598000000,242000000,242000000,-108000000,21000000,1272000000,1030000000,674000000,-105000000,116000000,115000000
119,2020-09-30,Ameren Corp,AEE,,432000000,367000000,-32000000,895000000,526000000,526000000,-110000000,63000000,1557000000,1031000000,662000000,-94000000,369000000,367000000
120,2021-06-30,American Airlines Group,AAL,,9000000,19000000,277000000,787000000,-929000000,-929000000,-486000000,-10000000,7478000000,8407000000,6691000000,938000000,19000000,19000000
121,2021-03-31,American Airlines Group,AAL,,-1573000000,-1250000000,151000000,-1806000000,-3151000000,-3151000000,-371000000,-323000000,4008000000,7159000000,5814000000,1578000000,-1250000000,-1250000000
122,2020-12-31,American Airlines Group,AAL,,-2809000000,-2178000000,95000000,-923000000,-2066000000,-2066000000,-376000000,-631000000,4028000000,6094000000,4951000000,-743000000,-2178000000,-2178000000
123,2020-09-30,American Airlines Group,AAL,,-3095000000,-2399000000,70000000,-2489000000,-3716000000,-3716000000,-340000000,-696000000,3173000000,6889000000,5662000000,621000000,-2399000000,-2399000000
124,2021-06-30,American Electric Power,AEP,,635000000,578200000,-29700000,1871300000,839600000,839600000,-301600000,61200000,3826500000,2986900000,1955200000,-204600000,573800000,578200000
125,2021-03-31,American Electric Power,AEP,,633300000,575000000,-29600000,1853100000,839900000,839900000,-290200000,54500000,4281100000,3441200000,2428000000,-206600000,578800000,575000000
126,2020-12-31,American Electric Power,AEP,,417300000,435500000,-29800000,1575900000,600000000,600000000,-288300000,-17400000,3610600000,3010600000,2034700000,-182700000,434700000,435500000
127,2020-09-30,American Electric Power,AEP,,747000000,748600000,-29700000,1925500000,972900000,972900000,-291300000,-1200000,4066400000,3093500000,2140900000,-225900000,748200000,748600000
128,2021-06-30,American Express,AXP,,2940000000,2280000000,3758000000,7705000000,0,2701000000,,660000000,10849000000,8148000000,3144000000,239000000,2280000000,2249000000
129,2021-03-31,American Express,AXP,,2993000000,2235000000,3316000000,7179000000,0,2621000000,,758000000,9739000000,7118000000,2560000000,372000000,2235000000,2206000000
130,2020-12-31,American Express,AXP,,1858000000,1438000000,3601000000,6859000000,0,1995000000,,420000000,9462000000,7467000000,2603000000,-137000000,1438000000,1414000000
131,2020-09-30,American Express,AXP,,1364000000,1073000000,3230000000,5823000000,0,1360000000,,291000000,8086000000,6726000000,2263000000,4000000,1073000000,1050000000
132,2021-06-30,American International Group,AIG,,147000000,99000000,2092000000,2662000000,570000000,570000000,-338000000,-3000000,10533000000,9963000000,7871000000,-423000000,150000000,91000000
133,2021-03-31,American International Group,AIG,,4728000000,3876000000,2014000000,7198000000,5184000000,5184000000,-342000000,798000000,14509000000,9325000000,7311000000,-456000000,3930000000,3869000000
134,2020-12-31,American International Group,AIG,,-558000000,-53000000,2054000000,1491000000,-563000000,-563000000,-358000000,-542000000,9332000000,9895000000,7841000000,5000000,-16000000,-60000000
135,2020-09-30,American International Group,AIG,,368000000,288000000,1891000000,2504000000,613000000,613000000,-379000000,74000000,9965000000,9352000000,7461000000,-245000000,294000000,281000000
136,2021-06-30,American Tower,AMT,,820700000,746300000,207200000,1651000000,887500000,887500000,-213700000,72800000,2298900000,1411400000,647900000,-66800000,747900000,746300000
137,2021-03-31,American Tower,AMT,,702600000,645000000,182600000,1584200000,875900000,875900000,-207000000,50300000,2158500000,1282600000,574300000,-173300000,652300000,645000000
138,2020-12-31,American Tower,AMT,,419700000,365100000,196300000,1549900000,859800000,859800000,-196100000,58100000,2122500000,1262700000,572600000,-440100000,361600000,365100000
139,2020-09-30,American Tower,AMT,,502200000,464400000,176000000,1450300000,802700000,802700000,-190900000,39300000,2012900000,1210200000,562600000,-300500000,462900000,464400000
140,2021-06-30,American Water Works,AWK,,251000000,207000000,-19000000,568000000,349000000,349000000,-101000000,44000000,999000000,650000000,431000000,-98000000,207000000,207000000
141,2021-03-31,American Water Works,AWK,,155000000,133000000,-20000000,469000000,249000000,249000000,-98000000,22000000,888000000,639000000,419000000,-94000000,133000000,133000000
142,2020-12-31,American Water Works,AWK,,181000000,145000000,-12000000,494000000,275000000,275000000,-99000000,36000000,923000000,648000000,429000000,-94000000,145000000,145000000
143,2020-09-30,American Water Works,AWK,,352000000,264000000,-12000000,660000000,445000000,445000000,-99000000,88000000,1079000000,634000000,419000000,-93000000,264000000,264000000
144,2021-06-30,Ameriprise Financial,AMP,,721000000,591000000,823000000,1720000000,897000000,897000000,-169000000,130000000,3420000000,2523000000,1700000000,-176000000,591000000,591000000
145,2021-03-31,Ameriprise Financial,AMP,,493000000,437000000,823000000,1522000000,699000000,699000000,-206000000,56000000,3355000000,2656000000,1833000000,-206000000,437000000,437000000
146,2020-12-31,Ameriprise Financial,AMP,,190000000,177000000,828000000,1183000000,355000000,355000000,-165000000,13000000,3189000000,2834000000,2006000000,-165000000,177000000,177000000
147,2020-09-30,Ameriprise Financial,AMP,,-184000000,-140000000,762000000,796000000,34000000,34000000,-217000000,-44000000,3013000000,2979000000,2217000000,-218000000,-140000000,-140000000
148,2021-06-30,AmerisourceBergen,ABC,,573530000,292122000,913414000,1888206000,847691000,847691000,-53011000,278082000,53405695000,52558004000,51517489000,-274161000,295448000,292122000
149,2021-03-31,AmerisourceBergen,ABC,,566511000,435267000,730081000,1533381000,702503000,702503000,-35184000,132506000,49154171000,48451668000,47620790000,-135992000,434005000,435267000
150,2020-12-31,AmerisourceBergen,ABC,,527882000,374845000,735068000,1452230000,617609000,617609000,-34578000,149175000,52516556000,51898947000,51064326000,-89727000,378707000,374845000
151,2020-09-30,AmerisourceBergen,ABC,,-6143457000,-4846072000,671028000,1346317000,577952000,577952000,-35761000,-1298952000,49244768000,48666816000,47898451000,-6721409000,-4844505000,-4846072000
152,2021-06-30,Ametek,AME,,291755000,231679000,157023000,473634000,316611000,316611000,-20442000,60076000,1386346000,1069735000,912712000,-24856000,231679000,231679000
153,2021-03-31,Ametek,AME,,272456000,219233000,138440000,426350000,287910000,287910000,-18947000,53223000,1215742000,927832000,789392000,-15454000,219233000,219233000
154,2020-12-31,Ametek,AME,,276707000,221025000,135844000,428979000,293135000,293135000,-19465000,55682000,1198947000,905812000,769968000,-16428000,221025000,221025000
155,2020-09-30,Ametek,AME,,248075000,204581000,128482000,394237000,265755000,265755000,-21187000,43494000,1126942000,861187000,732705000,-17680000,204581000,204581000
156,2021-06-30,Amgen,AMGN,1082000000,558000000,464000000,1384000000,4889000000,2333000000,2333000000,-281000000,94000000,6526000000,4193000000,1637000000,-1775000000,464000000,464000000
157,2021-03-31,Amgen,AMGN,967000000,1857000000,1646000000,1254000000,4411000000,2129000000,2129000000,-285000000,211000000,5901000000,3772000000,1490000000,-272000000,1646000000,1646000000
158,2020-12-31,Amgen,AMGN,1229000000,1877000000,1615000000,1773000000,5037000000,2035000000,2035000000,-94000000,262000000,6634000000,4599000000,1597000000,-158000000,1615000000,1615000000
159,2020-09-30,Amgen,AMGN,1062000000,2206000000,2021000000,1346000000,4862000000,2453000000,2453000000,-302000000,185000000,6423000000,3970000000,1561000000,-247000000,2021000000,2021000000
160,2021-03-31,Amphenol,APH,,435900000,329600000,262700000,727500000,464800000,464800000,-28600000,104100000,2377100000,1912300000,1649600000,-28900000,331800000,329600000
161,2020-12-31,Amphenol,APH,260700000,460200000,357000000,11900000,765600000,493000000,493000000,-28300000,100000000,2426000000,1933000000,1660400000,-32800000,360200000,357000000
162,2020-09-30,Amphenol,APH,260700000,448800000,346600000,259100000,734900000,475800000,475800000,-28000000,99300000,2323400000,1847600000,1588500000,-27000000,349500000,346600000
163,2020-06-30,Amphenol,APH,260700000,328500000,257700000,246400000,603800000,357400000,357400000,-30200000,68000000,1987500000,1630100000,1383700000,-28900000,260500000,257700000
164,2021-07-31,Analog Devices,ADI,306617000,572278000,503311000,187776000,1221184000,619008000,619008000,-44659000,68967000,1758853000,1139845000,537669000,-46730000,503311000,503311000
165,2021-05-01,Analog Devices,ADI,302238000,475985000,422905000,183612000,1136637000,543001000,543001000,-43066000,53080000,1661407000,1118406000,524770000,-67016000,422905000,422905000
166,2021-01-30,Analog Devices,ADI,288150000,436618000,388519000,170075000,1045371000,479498000,479498000,-42479000,48099000,1558458000,1078960000,513087000,-42880000,388519000,388519000
167,2020-10-31,Analog Devices,ADI,280239000,417310000,386526000,146219000,1023084000,488619000,488619000,-48593000,30784000,1526295000,1037676000,503211000,-71309000,386526000,386526000
168,2021-06-30,Ansys,ANSS,100879000,128860000,93716000,159089000,397521000,118094000,118094000,-3336000,35144000,446654000,328560000,49133000,10766000,93716000,93716000
169,2021-03-31,Ansys,ANSS,100479000,47623000,72398000,144245000,316072000,51992000,51992000,-3315000,-24775000,363226000,311234000,47154000,-4369000,72398000,72398000
170,2020-12-31,Ansys,ANSS,96510000,257872000,215632000,193524000,567198000,261712000,261712000,-2444000,42240000,623686000,361974000,56488000,-3840000,215632000,215632000
171,2020-09-30,Ansys,ANSS,86616000,90144000,75627000,131093000,323491000,91634000,91634000,-1853000,14517000,366965000,275331000,43474000,-1490000,75627000,75627000
172,2021-09-30,Anthem,ANTM,,1996000000,1509000000,6844000000,9177000000,2197000000,2197000000,-201000000,494000000,35822000000,33625000000,26645000000,-201000000,1502000000,1509000000
173,2021-06-30,Anthem,ANTM,,2353000000,1793000000,6435000000,9088000000,2563000000,2563000000,-205000000,552000000,33851000000,31288000000,24763000000,-210000000,1801000000,1793000000
174,2021-03-31,Anthem,ANTM,,2176000000,1665000000,6238000000,8686000000,2368000000,2368000000,-192000000,509000000,32385000000,30017000000,23699000000,-192000000,1667000000,1665000000
175,2020-12-31,Anthem,ANTM,,611000000,551000000,6840000000,7737000000,805000000,805000000,-192000000,60000000,31825000000,31020000000,24088000000,-194000000,551000000,551000000
176,2021-06-30,Aon,AON,,596000000,379000000,471000000,1266000000,718000000,718000000,-78000000,203000000,2886000000,2168000000,1620000000,-122000000,393000000,379000000
177,2021-03-31,Aon,AON,,1167000000,913000000,445000000,1812000000,1286000000,1286000000,-79000000,234000000,3525000000,2239000000,1713000000,-119000000,933000000,913000000
178,2020-12-31,Aon,AON,,626000000,524000000,504000000,1333000000,745000000,745000000,-82000000,92000000,2965000000,2220000000,1632000000,-119000000,534000000,524000000
179,2020-09-30,Aon,AON,,363000000,275000000,422000000,1002000000,488000000,488000000,-80000000,82000000,2385000000,1897000000,1383000000,-125000000,281000000,275000000
180,2021-06-30,APA Corporation,APA,,495000000,316000000,86000000,1196000000,510000000,510000000,-111000000,87000000,1830000000,1320000000,634000000,-15000000,408000000,316000000
181,2021-03-31,APA Corporation,APA,,620000000,388000000,83000000,1116000000,745000000,745000000,-112000000,170000000,1932000000,1187000000,816000000,-125000000,450000000,388000000
182,2020-12-31,APA Corporation,APA,,70000000,10000000,76000000,746000000,-4110000000,-4110000000,-110000000,15000000,1136000000,5246000000,390000000,4180000000,55000000,10000000
183,2020-09-30,APA Corporation,APA,,72000000,-4000000,52000000,732000000,179000000,179000000,-112000000,31000000,1129000000,950000000,397000000,-107000000,41000000,-4000000
184,2021-06-26,Apple,AAPL,5717000000,24369000000,21744000000,5412000000,35255000000,24126000000,24126000000,-665000000,2625000000,81434000000,57308000000,46179000000,243000000,21744000000,21744000000
185,2021-03-27,Apple,AAPL,5262000000,28011000000,23630000000,5314000000,38079000000,27503000000,27503000000,-670000000,4381000000,89584000000,62081000000,51505000000,508000000,23630000000,23630000000
186,2020-12-26,Apple,AAPL,5163000000,33579000000,28755000000,5631000000,44328000000,33534000000,33534000000,-638000000,4824000000,111439000000,77905000000,67111000000,45000000,28755000000,28755000000
187,2020-09-26,Apple,AAPL,4978000000,14901000000,12673000000,4936000000,24689000000,14775000000,14775000000,-634000000,2228000000,64698000000,49923000000,40009000000,126000000,12673000000,12673000000
188,2021-08-01,Applied Materials,AMAT,640000000,1980000000,1716000000,309000000,2967000000,2018000000,2018000000,-57000000,264000000,6196000000,4178000000,3229000000,-38000000,1716000000,1716000000
189,2021-05-02,Applied Materials,AMAT,617000000,1545000000,1330000000,285000000,2653000000,1751000000,1751000000,-61000000,215000000,5582000000,3831000000,2929000000,-206000000,1330000000,1330000000
190,2021-01-31,Applied Materials,AMAT,606000000,1240000000,1130000000,284000000,2361000000,1471000000,1471000000,-61000000,110000000,5162000000,3691000000,2801000000,-231000000,1130000000,1130000000
191,2020-10-25,Applied Materials,AMAT,560000000,1243000000,1131000000,261000000,2130000000,1309000000,1309000000,-59000000,112000000,4688000000,3379000000,2558000000,-66000000,1131000000,1131000000
192,2021-06-30,Aptiv,APTV,,194000000,163000000,275000000,602000000,290000000,290000000,-38000000,28000000,3807000000,3517000000,3205000000,-96000000,166000000,147000000
193,2021-03-31,Aptiv,APTV,,348000000,295000000,260000000,727000000,430000000,430000000,-40000000,48000000,4023000000,3593000000,3296000000,-82000000,300000000,279000000
194,2020-12-31,Aptiv,APTV,,370000000,299000000,309000000,812000000,466000000,466000000,-39000000,55000000,4212000000,3746000000,3400000000,-96000000,315000000,283000000
195,2020-09-30,Aptiv,APTV,,303000000,299000000,262000000,674000000,376000000,376000000,-38000000,-2000000,3668000000,3292000000,2994000000,-73000000,305000000,283000000
196,2021-06-30,Arista Networks,ANET,143293000,221084000,196888000,91520000,454178000,219365000,219365000,,24196000,707319000,487954000,253141000,1719000,196888000,196888000
197,2021-03-31,Arista Networks,ANET,132487000,207867000,180366000,86493000,425272000,206292000,206292000,,27501000,667562000,461270000,242290000,1575000,180366000,180366000
198,2020-12-31,Arista Networks,ANET,141147000,200180000,182958000,84099000,414584000,189338000,189338000,,17222000,648482000,459144000,233898000,10842000,182958000,182958000
199,2020-09-30,Arista Networks,ANET,128049000,201619000,168375000,68518000,384962000,188395000,188395000,,33244000,605431000,417036000,220469000,13224000,168375000,168375000
200,2021-06-30,Arthur J. Gallagher & Co.,AJG,,222300000,190200000,237600000,686900000,304100000,304100000,-56200000,20500000,1878100000,1574000000,1191200000,-81800000,201800000,190200000
201,2021-03-31,Arthur J. Gallagher & Co.,AJG,,408400000,382100000,228600000,841300000,469400000,469400000,-48100000,14700000,2111400000,1642000000,1270100000,-61000000,393700000,382100000
202,2020-12-31,Arthur J. Gallagher & Co.,AJG,,133700000,142200000,220800000,569600000,267000000,267000000,-47800000,-19400000,1651300000,1384300000,1081700000,-133300000,153100000,142200000
203,2020-09-30,Arthur J. Gallagher & Co.,AJG,,209500000,176600000,197400000,614100000,282800000,282800000,-48100000,21700000,1785700000,1502900000,1171600000,-73300000,187800000,176600000
204,2021-06-30,Assurant,AIZ,,236600000,203400000,,301400000,265400000,265400000,-28800000,51900000,2542300000,2276900000,2240900000,-28800000,184700000,203400000
205,2021-03-31,Assurant,AIZ,,193100000,163000000,1682400000,261200000,221500000,221500000,-28400000,44600000,2432600000,2211100000,2171400000,-28400000,148500000,158300000
206,2020-12-31,Assurant,AIZ,,183400000,139200000,1682400000,329400000,229500000,229500000,-26800000,44400000,2555100000,2325600000,2225700000,-46100000,139000000,134500000
207,2020-09-30,Assurant,AIZ,,-4100000,-30200000,1682400000,194500000,165300000,165300000,-25500000,26400000,2502500000,2337200000,2308000000,-169400000,-30500000,-34900000
208,2021-06-30,AT&T,T,,2625000000,1570000000,8390000000,22946000000,8795000000,8795000000,-1684000000,751000000,44045000000,35250000000,21099000000,-6170000000,1874000000,1514000000
209,2021-03-31,AT&T,T,,10064000000,7550000000,5297000000,22852000000,11746000000,11746000000,-1870000000,2122000000,43939000000,32193000000,21087000000,-1682000000,7942000000,7500000000
210,2020-12-31,AT&T,T,,-15553000000,-13883000000,12866000000,22781000000,2936000000,2936000000,-1894000000,-2038000000,45691000000,42755000000,22910000000,-18489000000,-13515000000,-13938000000
211,2020-09-30,AT&T,T,,3934000000,2816000000,8248000000,22501000000,7223000000,7223000000,-1972000000,766000000,42340000000,35117000000,19839000000,-3289000000,3168000000,2762000000
212,2021-06-30,Atmos Energy,ATO,,118315000,102411000,10133000,334213000,123257000,123257000,-20962000,15904000,605553000,482296000,271340000,-4942000,102411000,102341000
213,2021-03-31,Atmos Energy,ATO,,358542000,296754000,1252000,588889000,380552000,380552000,-26096000,61788000,1319073000,938521000,730184000,-22010000,296754000,296555000
214,2020-12-31,Atmos Energy,ATO,,282902000,217678000,1253000,487577000,297587000,297587000,-22010000,65224000,914480000,616893000,426903000,-14685000,217678000,217527000
215,2020-09-30,Atmos Energy,ATO,,83389000,65333000,-1866000,276811000,102711000,102711000,-15494000,18056000,474914000,372203000,198103000,-19322000,65333000,65297000
216,2021-07-31,Autodesk,ADSK,267800000,138800000,115600000,522700000,968100000,152900000,152900000,-12800000,23200000,1059700000,906800000,91600000,-14100000,115600000,115600000
217,2021-04-30,Autodesk,ADSK,255800000,131400000,155600000,487000000,906900000,145700000,145700000,-10600000,-24200000,989300000,843600000,82400000,-14300000,155600000,155600000
218,2021-01-31,Autodesk,ADSK,244000000,171100000,911300000,501600000,957300000,194500000,194500000,-6200000,-740200000,1039200000,844700000,81900000,-23400000,911300000,911300000
219,2020-10-31,Autodesk,ADSK,223400000,156100000,132200000,463400000,876500000,172500000,172500000,-14600000,23900000,952400000,779900000,75900000,-16400000,132200000,132200000
220,2021-06-30,Automatic Data Processing,ADP,,697100000,538200000,850300000,1631000000,681200000,681200000,-17300000,158900000,3737000000,3055800000,2106000000,15900000,538200000,538200000
221,2021-03-31,Automatic Data Processing,ADP,,1066200000,810700000,747500000,1923900000,1076400000,1076400000,-13500000,255500000,4102000000,3025600000,2178100000,-10200000,810700000,810700000
222,2020-12-31,Automatic Data Processing,ADP,,832600000,647500000,744300000,1673400000,829000000,829000000,-13900000,185100000,3695700000,2866700000,2022300000,3600000,647500000,647500000
223,2020-09-30,Automatic Data Processing,ADP,,765200000,602100000,667600000,1539900000,768800000,768800000,-15100000,163100000,3470700000,2701900000,1930800000,-3600000,602100000,602100000
224,2021-08-28,AutoZone,AZO,,985910000,785771000,1526809000,2567839000,1041030000,1041030000,-63537000,200139000,4913484000,3872454000,2345645000,-55120000,785771000,785771000
225,2021-05-08,AutoZone,AZO,,758479000,596164000,1111441000,1914946000,803505000,803505000,-45026000,162315000,3651023000,2847518000,1736077000,-45026000,596164000,596164000
226,2021-02-13,AutoZone,AZO,,435755000,345946000,1037716000,1559383000,521667000,521667000,-46012000,89809000,2910818000,2389151000,1351435000,-85912000,345946000,345946000
227,2020-11-21,AutoZone,AZO,,569046000,442433000,1060392000,1675617000,615225000,615225000,-46179000,126613000,3154261000,2539036000,1478644000,-46179000,442433000,442433000
228,2021-06-30,AvalonBay Communities,AVB,,447987000,447953000,19112000,347692000,144108000,144108000,-56104000,10000,561743000,417635000,214051000,303879000,447977000,447953000
229,2021-03-31,AvalonBay Communities,AVB,,141479000,142223000,18265000,342152000,140590000,140590000,-52613000,-755000,551196000,410606000,209044000,889000,142234000,141899000
230,2020-12-31,AvalonBay Communities,AVB,,338936000,341128000,10914000,337684000,148947000,148947000,-51589000,-2178000,548710000,399763000,211026000,189989000,341114000,340331000
231,2020-09-30,AvalonBay Communities,AVB,,147690000,147703000,13985000,359605000,170272000,170272000,-53249000,-27000,573015000,402743000,213410000,-22582000,147717000,147361000
232,2021-07-03,Avery Dennison,AVY,,254200000,183800000,307000000,576300000,269300000,269300000,-16000000,70400000,2102000000,1832700000,1525700000,-15100000,183800000,183800000
233,2021-04-03,Avery Dennison,AVY,,267600000,209500000,312300000,597000000,284700000,284700000,-16200000,58100000,2051300000,1766600000,1454300000,-17100000,209500000,209500000
234,2021-01-02,Avery Dennison,AVY,112800000,254400000,191500000,178200000,571100000,280100000,280100000,-15600000,62900000,1990900000,1710800000,1419800000,-25700000,191500000,191500000
235,2020-09-26,Avery Dennison,AVY,112800000,196800000,150500000,258300000,484200000,225900000,225900000,-15600000,46300000,1729100000,1503200000,1244900000,-29100000,150500000,150500000
236,2021-09-30,Baker Hughes,BKR,,209000000,8000000,607000000,1010000000,403000000,403000000,-67000000,193000000,5093000000,4690000000,4083000000,-194000000,16000000,8000000
237,2021-06-30,Baker Hughes,BKR,,66000000,-68000000,636000000,976000000,280000000,280000000,-65000000,143000000,5142000000,4862000000,4166000000,-214000000,-77000000,-68000000
238,2021-03-31,Baker Hughes,BKR,,-536000000,-452000000,582000000,858000000,261000000,261000000,-74000000,69000000,4782000000,4521000000,3924000000,-797000000,-605000000,-452000000
239,2020-12-31,Baker Hughes,BKR,,1520000000,652000000,580000000,1037000000,463000000,463000000,-62000000,569000000,5495000000,5032000000,4458000000,1057000000,951000000,652000000
240,2021-06-30,Ball Corp,BLL,,318000000,202000000,166000000,699000000,361000000,361000000,-66000000,116000000,3459000000,3098000000,2760000000,-43000000,202000000,202000000
241,2021-03-31,Ball Corp,BLL,,232000000,200000000,157000000,632000000,307000000,307000000,-67000000,32000000,3125000000,2818000000,2493000000,-75000000,200000000,200000000
242,2020-12-31,Ball Corp,BLL,,234000000,227000000,162000000,654000000,323000000,323000000,-69000000,7000000,3102000000,2779000000,2448000000,-89000000,227000000,227000000
243,2020-09-30,Ball Corp,BLL,,313000000,241000000,121000000,663000000,382000000,382000000,-68000000,73000000,3093000000,2711000000,2430000000,-69000000,240000000,241000000
244,2021-09-30,Bank of America,BAC,,8950000000,7691000000,12675000000,23390000000,0,8950000000,,1259000000,23390000000,14440000000,0,0,7691000000,7260000000
245,2021-06-30,Bank of America,BAC,,8042000000,9224000000,13096000000,23087000000,0,8042000000,,-1182000000,23087000000,15045000000,0,0,9224000000,8964000000
246,2021-03-31,Bank of America,BAC,,9166000000,8050000000,13765000000,24681000000,0,9166000000,,1116000000,24681000000,15515000000,0,0,8050000000,7560000000
247,2020-12-31,Bank of America,BAC,,6119000000,5470000000,12395000000,20046000000,0,6119000000,,649000000,20046000000,13927000000,0,0,5470000000,5208000000
248,2021-07-31,Bath & Body Works Inc.,BBWI,,499000000,374000000,899000000,1498000000,599000000,599000000,-99000000,125000000,3318000000,2719000000,1820000000,-100000000,374000000,374000000
249,2021-05-01,Bath & Body Works Inc.,BBWI,,353000000,277000000,842000000,1414000000,572000000,572000000,-114000000,76000000,3024000000,2452000000,1610000000,-219000000,277000000,277000000
250,2021-01-30,Bath & Body Works Inc.,BBWI,,1155000000,860000000,1731000000,3069000000,1338000000,1338000000,-116000000,295000000,4818000000,3480000000,1749000000,-183000000,860000000,860000000
251,2020-10-31,Bath & Body Works Inc.,BBWI,,410000000,331000000,808000000,1359000000,551000000,551000000,-121000000,79000000,3055000000,2504000000,1696000000,-141000000,331000000,331000000
252,2021-06-30,Baxter International,BAX,139000000,392000000,298000000,652000000,1254000000,463000000,463000000,-37000000,91000000,3098000000,2635000000,1844000000,-71000000,301000000,298000000
253,2021-03-31,Baxter International,BAX,128000000,351000000,298000000,624000000,1174000000,422000000,422000000,-37000000,51000000,2946000000,2524000000,1772000000,-71000000,300000000,298000000
254,2020-12-31,Baxter International,BAX,132000000,210000000,168000000,621000000,1260000000,507000000,507000000,-41000000,39000000,3181000000,2674000000,1921000000,-297000000,171000000,168000000
255,2020-09-30,Baxter International,BAX,122000000,415000000,356000000,574000000,1209000000,513000000,513000000,-42000000,56000000,2972000000,2459000000,1763000000,-98000000,359000000,356000000
256,2021-06-30,Becton Dickinson,BDX,344000000,514000000,525000000,1238000000,2161000000,579000000,579000000,-115000000,-11000000,4890000000,4311000000,2729000000,-65000000,525000000,502000000
257,2021-03-31,Becton Dickinson,BDX,317000000,305000000,299000000,1144000000,2283000000,822000000,822000000,-124000000,6000000,4907000000,4085000000,2624000000,-517000000,299000000,276000000
258,2020-12-31,Becton Dickinson,BDX,291000000,1157000000,1003000000,1144000000,2766000000,1331000000,1331000000,-118000000,154000000,5315000000,3984000000,2549000000,-174000000,1003000000,980000000
259,2020-09-30,Becton Dickinson,BDX,299000000,143000000,128000000,1205000000,2509000000,997000000,997000000,-123000000,15000000,4784000000,3787000000,2275000000,-854000000,128000000,105000000
260,2021-07-31,Best Buy,BBY,,798000000,734000000,1989000000,2810000000,801000000,801000000,-6000000,64000000,11849000000,11048000000,9039000000,-3000000,734000000,734000000
261,2021-05-01,Best Buy,BBY,,767000000,595000000,1968000000,2709000000,721000000,721000000,-6000000,172000000,11637000000,10916000000,8928000000,46000000,595000000,595000000
262,2021-01-30,Best Buy,BBY,,1043000000,816000000,2348000000,3530000000,1162000000,1162000000,-9000000,227000000,16937000000,15775000000,13407000000,-119000000,816000000,816000000
263,2020-10-31,Best Buy,BBY,,555000000,391000000,2103000000,2831000000,708000000,708000000,-11000000,164000000,11853000000,11145000000,9022000000,-153000000,391000000,391000000
264,2021-06-30,Bio-Rad Laboratories,BIO,65291000,1156775000,914114000,221425000,402698000,115982000,115982000,-363000,242661000,715931000,599949000,313233000,1040793000,914114000,914114000
265,2021-03-31,Bio-Rad Laboratories,BIO,56912000,1297203000,977414000,191653000,424527000,175962000,175962000,-398000,319789000,726796000,550834000,302269000,1121241000,977414000,977414000
266,2020-12-31,Bio-Rad Laboratories,BIO,66965000,1078533000,839102000,215448000,458255000,175842000,175842000,-4703000,239431000,789839000,613997000,331584000,902691000,839102000,839102000
267,2020-09-30,Bio-Rad Laboratories,BIO,59546000,1684461000,1314824000,199265000,367311000,108500000,108500000,-5728000,369637000,647263000,538763000,279952000,1575961000,1314824000,1314824000
268,2021-06-30,Bio-Techne,TECH,20721000,7113000,14960000,85691000,177509000,71097000,71097000,-3291000,-7531000,259028000,187931000,81519000,-63984000,14644000,14951000
269,2021-03-31,Bio-Techne,TECH,17052000,45354000,45782000,80865000,168274000,70357000,70357000,-2660000,-48000,243552000,173195000,75278000,-25003000,45402000,45755000
270,2020-12-31,Bio-Techne,TECH,16789000,56368000,46274000,78695000,150923000,55439000,55439000,-3585000,10224000,224253000,168814000,73330000,929000,46144000,46237000
271,2020-09-30,Bio-Techne,TECH,16041000,39339000,33395000,72748000,137731000,48942000,48942000,-4416000,5944000,204199000,155257000,66468000,-9603000,33395000,33374000
272,2021-06-30,Biogen,BIIB,585100000,616400000,448500000,637300000,2315300000,504000000,504000000,-56400000,-409100000,2775000000,2271000000,459700000,112400000,1025500000,448500000
273,2021-03-31,Biogen,BIIB,514200000,448800000,410200000,595000000,2215900000,940100000,940100000,-64700000,44200000,2694000000,1753900000,478100000,-491300000,404600000,410200000
274,2020-12-31,Biogen,BIIB,1719800000,370900000,357900000,813200000,2362000000,-296200000,-296200000,-56000000,13300000,2852600000,3148800000,490600000,667100000,357600000,357900000
275,2020-09-30,Biogen,BIIB,1140900000,944700000,701500000,573100000,2927000000,1076700000,1076700000,-56300000,240800000,3376100000,2299400000,449100000,-132000000,703900000,701500000
276,2021-06-30,BlackRock,BLK,,2201000000,1378000000,460000000,2429000000,1932000000,1932000000,-52000000,654000000,4820000000,2888000000,2391000000,269000000,1547000000,1378000000
277,2021-03-31,BlackRock,BLK,,1591000000,1199000000,582000000,2164000000,1548000000,1548000000,-55000000,318000000,4398000000,2850000000,2234000000,43000000,1273000000,1199000000
278,2020-12-31,BlackRock,BLK,,2167000000,1548000000,474000000,2349000000,1848000000,1848000000,-54000000,427000000,4478000000,2630000000,2129000000,319000000,1740000000,1548000000
279,2020-09-30,BlackRock,BLK,,1981000000,1364000000,461000000,2245000000,1757000000,1757000000,-54000000,464000000,4369000000,2612000000,2124000000,224000000,1517000000,1364000000
280,2021-09-30,BNY Mellon,BK,,1162000000,947000000,2461000000,4080000000,0,1181000000,,219000000,4080000000,2899000000,0,-19000000,943000000,881000000
281,2021-06-30,BNY Mellon,BK,,1268000000,1022000000,2390000000,4046000000,0,1288000000,,241000000,4046000000,2758000000,0,-20000000,1027000000,990000000
282,2021-03-31,BNY Mellon,BK,,1153000000,927000000,2449000000,4004000000,0,1177000000,,221000000,4004000000,2827000000,0,-24000000,932000000,857000000
283,2020-12-31,BNY Mellon,BK,,903000000,750000000,2493000000,3828000000,0,929000000,,148000000,3828000000,2899000000,0,-26000000,755000000,701000000
284,2021-09-30,Boeing,BA,575000000,-310000000,-109000000,1062000000,2130000000,493000000,493000000,-669000000,-178000000,15278000000,14785000000,13148000000,-803000000,-132000000,-109000000
285,2021-06-30,Boeing,BA,497000000,549000000,587000000,860000000,2925000000,1568000000,1568000000,-673000000,-18000000,16998000000,15430000000,14073000000,-1019000000,567000000,587000000
286,2021-03-31,Boeing,BA,499000000,-572000000,-537000000,850000000,1977000000,628000000,628000000,-679000000,-11000000,15217000000,14589000000,13240000000,-1200000000,-561000000,-537000000
287,2020-12-31,Boeing,BA,605000000,-8625000000,-8420000000,1722000000,-4062000000,-6389000000,-6389000000,-698000000,-186000000,15304000000,21693000000,19366000000,-2236000000,-8439000000,-8420000000
288,2021-06-30,Booking Holdings,BKNG,,-41000000,-167000000,1421000000,1474000000,-55000000,-55000000,-81000000,126000000,2160000000,2215000000,686000000,14000000,-167000000,-167000000
289,2021-03-31,Booking Holdings,BKNG,,-278000000,-55000000,779000000,589000000,-303000000,-303000000,-98000000,-223000000,1141000000,1444000000,552000000,25000000,-55000000,-55000000
290,2020-12-31,Booking Holdings,BKNG,,245000000,-165000000,712000000,747000000,-79000000,-79000000,-98000000,410000000,1238000000,1317000000,491000000,324000000,-165000000,-165000000
291,2020-09-30,Booking Holdings,BKNG,,835000000,801000000,1079000000,2123000000,929000000,929000000,-98000000,34000000,2640000000,1711000000,517000000,-94000000,801000000,801000000
292,2021-06-30,BorgWarner,BWA,,302000000,247000000,352000000,762000000,413000000,413000000,-42000000,28000000,3758000000,3345000000,2996000000,-111000000,274000000,247000000
293,2021-03-31,BorgWarner,BWA,,136000000,65000000,366000000,818000000,455000000,455000000,-21000000,42000000,4009000000,3554000000,3191000000,-319000000,94000000,65000000
294,2020-12-31,BorgWarner,BWA,,596000000,358000000,348000000,772000000,423000000,423000000,-23000000,211000000,3926000000,3503000000,3154000000,173000000,385000000,358000000
295,2020-09-30,BorgWarner,BWA,,272000000,111000000,202000000,517000000,319000000,319000000,-20000000,143000000,2534000000,2215000000,2017000000,-47000000,129000000,111000000
296,2021-06-30,Boston Properties,BXP,,141250000,111703000,38405000,457565000,245822000,245822000,-106319000,0,709015000,463193000,251450000,-104572000,141250000,111703000
297,2021-03-31,Boston Properties,BXP,,128147000,100596000,44959000,446779000,231055000,231055000,-107902000,0,706550000,475495000,259771000,-102908000,128147000,91624000
298,2020-12-31,Boston Properties,BXP,,24905000,10311000,31053000,393120000,194054000,194054000,-111991000,0,650769000,456715000,257649000,-169149000,24905000,8088000
299,2020-09-30,Boston Properties,BXP,,118060000,92479000,27862000,424219000,229901000,229901000,-110993000,0,685951000,456050000,261732000,-111841000,118060000,89854000
300,2021-06-30,Boston Scientific,BSX,298000000,149000000,186000000,1121000000,2120000000,521000000,521000000,-86000000,-37000000,3077000000,2556000000,957000000,-372000000,186000000,172000000
301,2021-03-31,Boston Scientific,BSX,276000000,325000000,341000000,1019000000,1846000000,366000000,366000000,-82000000,-16000000,2752000000,2386000000,906000000,-41000000,341000000,327000000
302,2020-12-31,Boston Scientific,BSX,282000000,306000000,210000000,976000000,2086000000,634000000,634000000,-96000000,96000000,2709000000,2075000000,623000000,-328000000,210000000,196000000
303,2020-09-30,Boston Scientific,BSX,315000000,-227000000,-155000000,984000000,1778000000,282000000,282000000,-86000000,-72000000,2659000000,2377000000,881000000,-509000000,-155000000,-169000000
304,2021-06-30,Bristol Myers Squibb,BMY,2261000000,1553000000,1055000000,1866000000,9340000000,2666000000,2666000000,-320000000,492000000,11703000000,9037000000,2363000000,-1113000000,1061000000,1055000000
305,2021-03-31,Bristol Myers Squibb,BMY,2225000000,2530000000,2021000000,1667000000,8649000000,2244000000,2244000000,-342000000,501000000,11073000000,8829000000,2424000000,286000000,2029000000,2021000000
306,2020-12-31,Bristol Myers Squibb,BMY,2579000000,-10451000000,-10027000000,2480000000,8833000000,1248000000,1248000000,-345000000,-424000000,11068000000,9820000000,2235000000,-11699000000,-10027000000,-10027000000
307,2020-09-30,Bristol Myers Squibb,BMY,2273000000,2257000000,1872000000,1694000000,8497000000,2039000000,2039000000,-336000000,379000000,10540000000,8501000000,2043000000,218000000,1878000000,1872000000
308,2021-08-01,Broadcom,AVGO,1205000000,1726000000,1876000000,346000000,5049000000,2153000000,2153000000,-415000000,-150000000,6778000000,4625000000,1729000000,-427000000,1876000000,1802000000
309,2021-05-02,Broadcom,AVGO,1238000000,1486000000,1493000000,325000000,4911000000,2001000000,2001000000,-466000000,-7000000,6610000000,4609000000,1699000000,-515000000,1493000000,1417000000
310,2021-01-31,Broadcom,AVGO,1211000000,1384000000,1378000000,339000000,4841000000,1923000000,1923000000,-570000000,6000000,6655000000,4732000000,1814000000,-539000000,1378000000,1304000000
311,2020-11-01,Broadcom,AVGO,1182000000,1137000000,1324000000,512000000,4714000000,1459000000,1459000000,-420000000,-187000000,6467000000,5008000000,1753000000,-322000000,1324000000,1250000000
312,2021-03-31,Broadridge Financial Solutions,BR,,216900000,165000000,190000000,429300000,239300000,239300000,-12000000,51900000,1389800000,1150500000,960500000,-22400000,165000000,165000000
313,2020-12-31,Broadridge Financial Solutions,BR,,69400000,56300000,169000000,248400000,79400000,79400000,-12100000,13100000,1054900000,975500000,806500000,-10000000,56300000,56300000
314,2020-09-30,Broadridge Financial Solutions,BR,,73600000,65800000,151700000,230300000,78600000,78600000,-15000000,7800000,1017400000,938800000,787100000,-5000000,65800000,65800000
315,2020-06-30,Broadridge Financial Solutions,BR,,294700000,229700000,178900000,477700000,298800000,298800000,-16200000,65000000,1361900000,1063100000,884200000,-4100000,229700000,229700000
316,2021-03-31,Brown & Brown,BRO,,239207000,199744000,,385528000,254216000,254216000,-16342000,39463000,815026000,560810000,429498000,-15009000,199744000,199744000
317,2020-12-31,Brown & Brown,BRO,,130916000,97320000,,267038000,139395000,139395000,-16639000,33596000,644508000,505113000,377470000,-8479000,97320000,97320000
318,2020-09-30,Brown & Brown,BRO,,158528000,133979000,,308629000,183520000,183520000,-13234000,24549000,671396000,487876000,362767000,-24992000,133979000,133979000
319,2020-06-30,Brown & Brown,BRO,,129401000,96784000,,251642000,143165000,143165000,-13809000,32617000,598157000,454992000,346515000,-13764000,96784000,96784000
320,2021-03-31,C. H. Robinson,CHRW,,212069000,173305000,118216000,341545000,223329000,223329000,-12200000,38764000,4803869000,4580540000,4462324000,-11260000,173305000,173305000
321,2020-12-31,C. H. Robinson,CHRW,,194769000,147807000,124516000,331318000,206802000,206802000,-12500000,46962000,4549452000,4342650000,4218134000,-12033000,147807000,147807000
322,2020-09-30,C. H. Robinson,CHRW,,160774000,136529000,118130000,286369000,168239000,168239000,-11900000,24245000,4224800000,4056561000,3938431000,-7465000,136529000,136529000
323,2020-06-30,C. H. Robinson,CHRW,,178576000,143939000,125183000,313970000,188787000,188787000,-12400000,34637000,3627846000,3439059000,3313876000,-10211000,143939000,143939000
324,2021-07-03,Cadence Design Systems,CDNS,285227000,183265000,155900000,176300000,651526000,184969000,184969000,-4316000,27365000,728285000,543316000,76759000,-1704000,155900000,155900000
325,2021-04-03,Cadence Design Systems,CDNS,270992000,202421000,187169000,172778000,652061000,203660000,203660000,-4217000,15252000,736028000,532368000,83967000,-1239000,187169000,187169000
326,2021-01-02,Cadence Design Systems,CDNS,290309000,186189000,173738000,195766000,686373000,195523000,195523000,-4873000,12451000,759909000,564386000,73536000,-9334000,173738000,173738000
327,2020-09-26,Cadence Design Systems,CDNS,250934000,165713000,161630000,159666000,584323000,169285000,169285000,-5325000,4083000,666607000,497322000,82284000,-3572000,161630000,161630000
328,2021-06-30,Caesars Entertainment,CZR,,101000000,71000000,494000000,1457000000,662000000,662000000,-576000000,-1000000,2502000000,1840000000,1045000000,-561000000,102000000,71000000
329,2021-03-31,Caesars Entertainment,CZR,,-496000000,-423000000,446000000,947000000,236000000,236000000,-579000000,-76000000,1792000000,1556000000,845000000,-732000000,-420000000,-423000000
330,2020-12-31,Caesars Entertainment,CZR,,-496000000,-555000000,462000000,712000000,102000000,102000000,-566000000,62000000,1489000000,1387000000,777000000,-598000000,-558000000,-555000000
331,2020-09-30,Caesars Entertainment,CZR,,-789000000,-926000000,420000000,710000000,-45000000,-45000000,-473000000,135000000,1377000000,1422000000,667000000,-744000000,-924000000,-926000000
332,2021-05-02,Campbell Soup,CPB,22000000,219000000,160000000,344000000,630000000,287000000,287000000,-53000000,53000000,1984000000,1697000000,1354000000,-68000000,166000000,160000000
333,2021-01-31,Campbell Soup,CPB,19000000,347000000,245000000,384000000,781000000,423000000,423000000,-55000000,102000000,2279000000,1856000000,1498000000,-76000000,245000000,245000000
334,2020-11-01,Campbell Soup,CPB,20000000,406000000,309000000,345000000,814000000,467000000,467000000,-55000000,97000000,2340000000,1873000000,1526000000,-61000000,309000000,309000000
335,2020-08-02,Campbell Soup,CPB,24000000,107000000,86000000,434000000,750000000,186000000,186000000,-61000000,21000000,2108000000,1922000000,1358000000,-79000000,86000000,86000000
336,2021-06-30,Capital One Financial,COF,,4568000000,3536000000,3580000000,8534000000,0,4613000000,,1031000000,8534000000,3921000000,0,-45000000,3537000000,3446000000
337,2021-03-31,Capital One Financial,COF,,4196000000,3325000000,3414000000,7936000000,0,4237000000,,869000000,7936000000,3699000000,0,-41000000,3327000000,3236000000
338,2020-12-31,Capital One Financial,COF,,3064000000,2566000000,3579000000,7073000000,0,3401000000,,496000000,7073000000,3672000000,0,-337000000,2568000000,2466000000
339,2020-09-30,Capital One Financial,COF,,3502000000,2406000000,3145000000,7050000000,0,3565000000,,1096000000,7050000000,3485000000,0,-63000000,2406000000,2319000000
340,2021-06-30,Cardinal Health,CAH,,119000000,116000000,1129000000,1672000000,437000000,437000000,-44000000,4000000,42586000000,42149000000,40914000000,-318000000,115000000,116000000
341,2021-03-31,Cardinal Health,CAH,,440000000,119000000,1120000000,1812000000,581000000,581000000,-45000000,320000000,39275000000,38694000000,37463000000,-141000000,120000000,119000000
342,2020-12-31,Cardinal Health,CAH,,427000000,629000000,1147000000,1776000000,513000000,513000000,-46000000,-203000000,41541000000,41028000000,39765000000,-86000000,630000000,629000000
343,2020-09-30,Cardinal Health,CAH,,-663000000,-253000000,1137000000,1715000000,460000000,460000000,-45000000,-410000000,39065000000,38605000000,37350000000,-1123000000,-253000000,-253000000
344,2021-05-31,CarMax,KMX,,567324000,436756000,554069000,1166240000,562281000,562281000,-20534000,130568000,8007899000,7445618000,6841659000,5043000,436756000,436756000
345,2021-02-28,CarMax,KMX,,262249000,209945000,556128000,829589000,273535000,273535000,-20289000,52304000,5455157000,5181622000,4625568000,-11286000,209945000,209945000
346,2020-11-30,CarMax,KMX,,310503000,235300000,478800000,807875000,329078000,329078000,-19462000,75203000,5473444000,5144366000,4665569000,-18575000,235300000,235300000
347,2020-08-31,CarMax,KMX,,388341000,296696000,490208000,899338000,409130000,409130000,-22469000,91645000,5652266000,5243136000,4752928000,-20789000,296696000,296696000
348,2021-05-31,Carnival Corporation,CCL,,-2060000000,-2072000000,417000000,-359000000,-1567000000,-1567000000,-437000000,12000000,49000000,1616000000,408000000,-493000000,-2072000000,-2072000000
349,2021-02-28,Carnival Corporation,CCL,,-1979000000,-1973000000,462000000,-328000000,-1523000000,-1523000000,-398000000,-6000000,26000000,1549000000,354000000,-456000000,-1973000000,-1973000000
350,2020-11-30,Carnival Corporation,CCL,,-2237000000,-2222000000,492000000,-351000000,-1555000000,-1555000000,-348000000,-15000000,33000000,1588000000,384000000,-682000000,-2222000000,-2222000000
351,2020-08-31,Carnival Corporation,CCL,,-2860000000,-2858000000,262000000,-400000000,-1421000000,-1421000000,-310000000,-2000000,31000000,1452000000,431000000,-1439000000,-2858000000,-2858000000
352,2021-06-30,Carrier Global,CARR,125000000,731000000,487000000,776000000,1625000000,739000000,739000000,-75000000,234000000,5440000000,4701000000,3815000000,-8000000,497000000,487000000
353,2021-03-31,Carrier Global,CARR,121000000,496000000,384000000,712000000,1399000000,569000000,569000000,-96000000,104000000,4699000000,4130000000,3300000000,-73000000,392000000,384000000
354,2020-12-31,Carrier Global,CARR,127000000,1176000000,884000000,874000000,1300000000,263000000,263000000,-85000000,289000000,4594000000,4331000000,3294000000,913000000,887000000,884000000
355,2020-09-30,Carrier Global,CARR,100000000,1009000000,741000000,637000000,1560000000,821000000,821000000,-90000000,261000000,5002000000,4181000000,3442000000,188000000,748000000,741000000
356,2021-06-30,Catalent,CTLT,,221500000,182400000,186200000,439300000,253100000,253100000,-31900000,39100000,1188200000,935100000,748900000,-31600000,182400000,168900000
357,2021-03-31,Catalent,CTLT,,317100000,231800000,172000000,365600000,193600000,193600000,-26900000,85300000,1053300000,859700000,687700000,123500000,231800000,217100000
358,2020-12-31,Catalent,CTLT,,109000000,88400000,164800000,298200000,133400000,133400000,-25900000,20600000,910800000,777400000,612600000,-24400000,88400000,74200000
359,2020-09-30,Catalent,CTLT,,67400000,82400000,164000000,248900000,84900000,84900000,-25300000,-15000000,845700000,760800000,596800000,-17500000,82400000,68800000
360,2021-03-31,Caterpillar,CAT,374000000,2006000000,1530000000,1004000000,3331000000,2000000000,2000000000,-142000000,475000000,11887000000,9887000000,8556000000,6000000,1531000000,1530000000
361,2020-12-31,Caterpillar,CAT,374000000,947000000,780000000,1276000000,2843000000,1200000000,1200000000,-130000000,167000000,11235000000,10035000000,8392000000,-253000000,780000000,780000000
362,2020-09-30,Caterpillar,CAT,344000000,858000000,668000000,933000000,2370000000,1110000000,1110000000,-136000000,187000000,9881000000,8771000000,7511000000,-252000000,671000000,668000000
363,2020-06-30,Caterpillar,CAT,341000000,686000000,458000000,1020000000,2245000000,912000000,912000000,-135000000,227000000,9997000000,9085000000,7752000000,-226000000,459000000,458000000
364,2021-06-30,Cboe Global Markets,CBOE,,179200000,105500000,113600000,350600000,191800000,191800000,-12400000,73700000,800800000,609000000,450200000,-12600000,105500000,105200000
365,2021-03-31,Cboe Global Markets,CBOE,,192900000,137200000,112000000,365500000,208000000,208000000,-12400000,55700000,1010800000,802800000,645300000,-15100000,137200000,136800000
366,2020-12-31,Cboe Global Markets,CBOE,,122900000,87300000,97400000,307100000,163600000,163600000,-13900000,35600000,844200000,680600000,537100000,-40700000,87300000,87100000
367,2020-09-30,Cboe Global Markets,CBOE,,163400000,109900000,95800000,292000000,152200000,152200000,-9600000,53500000,792700000,640500000,500700000,11200000,109900000,109600000
368,2021-06-30,CBRE,CBRE,,576887000,442637000,957216000,1441854000,365553000,365553000,-13772000,133445000,6458613000,6093060000,5016759000,211334000,443442000,442637000
369,2021-03-31,CBRE,CBRE,,345304000,266202000,828327000,1219333000,268928000,268928000,-10106000,76327000,5938879000,5669951000,4719546000,76376000,268977000,266202000
370,2020-12-31,CBRE,CBRE,,410440000,313765000,876050000,1566071000,566888000,566888000,-15958000,95054000,6910501000,6343613000,5344430000,-156448000,315386000,313765000
371,2020-09-30,CBRE,CBRE,,233902000,184132000,754527000,1096263000,214011000,214011000,-17829000,49062000,5645142000,5431131000,4548879000,19891000,184840000,184132000
372,2021-06-30,CDW,CDW,,371200000,274100000,512900000,882800000,369900000,369900000,-35500000,97100000,5146400000,4776500000,4263600000,1300000,274100000,274100000
373,2021-03-31,CDW,CDW,,288900000,232600000,471800000,795200000,323400000,323400000,-35600000,56300000,4837500000,4514100000,4042300000,-34500000,232600000,232600000
374,2020-12-31,CDW,CDW,,295000000,238300000,548700000,880900000,332200000,332200000,-37100000,56700000,4956200000,4624000000,4075300000,-37200000,238300000,238300000
375,2020-09-30,CDW,CDW,,250100000,193200000,499200000,825500000,326300000,326300000,-40200000,56900000,4756400000,4430100000,3930900000,-76200000,193200000,193200000
376,2021-06-30,Celanese,CE,22000000,660000000,538000000,123000000,761000000,611000000,611000000,-24000000,116000000,2198000000,1587000000,1437000000,49000000,544000000,538000000
377,2021-03-31,Celanese,CE,20000000,409000000,322000000,99000000,485000000,360000000,360000000,-25000000,85000000,1798000000,1438000000,1313000000,49000000,324000000,322000000
378,2020-12-31,Celanese,CE,20000000,1571000000,1453000000,202000000,376000000,149000000,149000000,-26000000,117000000,1591000000,1442000000,1215000000,1422000000,1454000000,1453000000
379,2020-09-30,Celanese,CE,19000000,241000000,207000000,78000000,327000000,224000000,224000000,-28000000,30000000,1411000000,1187000000,1084000000,17000000,211000000,207000000
380,2021-09-30,Centene Corporation,CNC,,720000000,584000000,2642000000,4970000000,702000000,702000000,-170000000,139000000,30400000000,29698000000,25430000000,18000000,581000000,584000000
381,2021-06-30,Centene Corporation,CNC,,-542000000,-535000000,2232000000,4574000000,974000000,974000000,-163000000,-7000000,28963000000,27989000000,24389000000,-1516000000,-535000000,-535000000
382,2021-03-31,Centene Corporation,CNC,,941000000,699000000,2265000000,4826000000,1259000000,1259000000,-170000000,244000000,28217000000,26958000000,23391000000,-318000000,697000000,699000000
383,2020-12-31,Centene Corporation,CNC,,-74000000,-12000000,2943000000,3945000000,274000000,274000000,-177000000,-55000000,26550000000,26276000000,22605000000,-348000000,-19000000,-12000000
384,2021-06-30,CenterPoint Energy,CNP,,248000000,251000000,-2000000,749000000,298000000,298000000,-124000000,-3000000,1742000000,1444000000,993000000,-50000000,251000000,221000000
385,2021-03-31,CenterPoint Energy,CNP,,437000000,363000000,-2000000,903000000,455000000,455000000,-119000000,74000000,2547000000,2092000000,1644000000,-18000000,363000000,334000000
386,2020-12-31,CenterPoint Energy,CNP,,254000000,200000000,26000000,741000000,282000000,282000000,-119000000,54000000,2054000000,1772000000,1313000000,-28000000,200000000,151000000
387,2020-09-30,CenterPoint Energy,CNP,,117000000,121000000,26000000,730000000,302000000,302000000,-128000000,-10000000,1622000000,1320000000,892000000,-185000000,127000000,69000000
388,2021-06-30,Ceridian,CDAY,,-37800000,-25800000,107200000,106600000,-14400000,-14400000,-9900000,-12000000,250400000,264800000,143800000,-23400000,-25800000,-25800000
389,2021-03-31,Ceridian,CDAY,,-12600000,-19200000,87400000,105200000,6700000,6700000,-5600000,6600000,234500000,227800000,129300000,-19300000,-19200000,-19200000
390,2020-12-31,Ceridian,CDAY,,-27600000,-17300000,80600000,96600000,5400000,5400000,-5700000,-10300000,222800000,217400000,126200000,-33000000,-17300000,-17300000
391,2020-09-30,Ceridian,CDAY,,-6300000,-800000,77500000,88600000,800000,800000,-5900000,-5500000,204400000,203600000,115800000,-7100000,-800000,-800000
392,2021-06-30,Cerner,CERN,193600000,47882000,32707000,765384000,1195430000,219560000,219560000,,15175000,1456755000,1237195000,261325000,-171678000,32707000,32707000
393,2021-03-31,Cerner,CERN,192327000,219264000,172252000,714541000,1157122000,238058000,238058000,,47012000,1387778000,1149720000,230656000,-18794000,172252000,172252000
394,2020-12-31,Cerner,CERN,197906000,176132000,141505000,728063000,1160352000,221819000,221819000,-29080000,34627000,1395025000,1173206000,234673000,-45687000,141505000,141505000
395,2020-09-30,Cerner,CERN,186826000,459840000,356676000,742218000,1136784000,194951000,194951000,-29080000,103164000,1368673000,1173722000,231889000,264889000,356676000,356676000
396,2021-06-30,CF Industries,CF,,402000000,246000000,60000000,503000000,442000000,442000000,-46000000,85000000,1588000000,1146000000,1085000000,-40000000,317000000,246000000
397,2021-03-31,CF Industries,CF,,193000000,151000000,55000000,289000000,236000000,236000000,-48000000,18000000,1048000000,812000000,759000000,-43000000,175000000,151000000
398,2020-12-31,CF Industries,CF,,117000000,87000000,51000000,180000000,129000000,129000000,-38000000,-2000000,1102000000,973000000,922000000,-12000000,119000000,87000000
399,2020-09-30,CF Industries,CF,,-9000000,-28000000,49000000,94000000,46000000,46000000,-48000000,-13000000,847000000,801000000,753000000,-55000000,4000000,-28000000
400,2021-06-26,Charles River Laboratories,CRL,,127496000,88448000,154756000,342414000,154688000,154688000,-16190000,37580000,914607000,759919000,572193000,-27192000,89916000,88448000
401,2021-03-27,Charles River Laboratories,CRL,,66302000,61530000,147890000,308841000,132109000,132109000,-29719000,2367000,824566000,692457000,515725000,-65807000,63935000,61530000
402,2020-12-26,Charles River Laboratories,CRL,,172427000,143191000,143735000,300631000,128888000,128888000,-33147000,28237000,790990000,662102000,490359000,43539000,144190000,143191000
403,2020-09-26,Charles River Laboratories,CRL,,135276000,102909000,128575000,290180000,133373000,133373000,-18867000,32665000,743300000,609927000,453120000,1903000,102611000,102909000
404,2021-06-30,Charles Schwab Corporation,SCHW,,1719000000,1265000000,1857000000,4361000000,0,1860000000,,454000000,4527000000,2667000000,166000000,-141000000,1265000000,1117000000
405,2021-03-31,Charles Schwab Corporation,SCHW,,1960000000,1484000000,1972000000,4568000000,0,2075000000,,476000000,4715000000,2640000000,147000000,-115000000,1484000000,1388000000
406,2020-12-31,Charles Schwab Corporation,SCHW,,1476000000,1135000000,1708000000,4049000000,0,1899000000,,341000000,4176000000,2277000000,127000000,-423000000,1135000000,1050000000
407,2020-09-30,Charles Schwab Corporation,SCHW,,889000000,698000000,1291000000,2375000000,0,889000000,,191000000,2448000000,1559000000,73000000,0,698000000,615000000
408,2021-09-30,Charter Communications,CHTR,,1754000000,1217000000,918000000,6091000000,2903000000,2903000000,-1016000000,347000000,13146000000,10243000000,7055000000,-1149000000,1407000000,1217000000
409,2021-06-30,Charter Communications,CHTR,,1439000000,1020000000,683000000,5776000000,2739000000,2739000000,-1004000000,281000000,12802000000,10063000000,7026000000,-1300000000,1158000000,1020000000
410,2021-03-31,Charter Communications,CHTR,,1137000000,807000000,733000000,5562000000,2388000000,2388000000,-983000000,216000000,12522000000,10134000000,6960000000,-1251000000,921000000,807000000
411,2020-12-31,Charter Communications,CHTR,,1655000000,1246000000,-3613000000,1321000000,2525000000,2525000000,-965000000,254000000,12624000000,10099000000,11303000000,-870000000,1401000000,1246000000
412,2021-06-30,Chevron Corporation,CVX,,4422000000,3082000000,6160000000,15488000000,3131000000,3131000000,-185000000,1328000000,36117000000,32986000000,20629000000,1291000000,3094000000,3082000000
413,2021-03-31,Chevron Corporation,CVX,,2177000000,1377000000,6294000000,13508000000,1383000000,1383000000,-198000000,779000000,31076000000,29693000000,17568000000,794000000,1398000000,1377000000
414,2020-12-31,Chevron Corporation,CVX,,-957000000,-665000000,5629000000,11456000000,2494000000,2494000000,-199000000,-301000000,24843000000,22349000000,13387000000,-3451000000,-656000000,-665000000
415,2020-09-30,Chevron Corporation,CVX,,-44000000,-207000000,5658000000,10549000000,-328000000,-328000000,-164000000,165000000,23997000000,24325000000,13448000000,284000000,-209000000,-207000000
416,2021-09-30,Chipotle Mexican Grill,CMG,,239554000,204434000,145930000,754003000,244338000,244338000,-126000,35120000,1952315000,1707977000,1198312000,-4784000,204434000,204434000
417,2021-06-30,Chipotle Mexican Grill,CMG,,246376000,187974000,146044000,750124000,249791000,249791000,-126000,58402000,1892538000,1642747000,1142414000,-3415000,187974000,187974000
418,2021-03-31,Chipotle Mexican Grill,CMG,,159274000,127101000,155103000,683466000,167110000,167110000,-2168000,32173000,1741575000,1574465000,1058109000,-7836000,127101000,127101000
419,2020-12-31,Chipotle Mexican Grill,CMG,,117732000,190959000,276195000,601683000,131149000,131149000,-554000,-73227000,1607710000,1476561000,1006027000,-13417000,190959000,190959000
420,2021-06-30,Chubb,CB,,2582000000,2265000000,775000000,2790000000,1930000000,1930000000,-122000000,317000000,9679000000,7749000000,6889000000,652000000,2265000000,2265000000
421,2021-03-31,Chubb,CB,,2638000000,2300000000,744000000,3090000000,2263000000,2263000000,-122000000,338000000,9975000000,7712000000,6885000000,375000000,2300000000,2300000000
422,2020-12-31,Chubb,CB,,2752000000,2418000000,877000000,3256000000,2294000000,2294000000,-126000000,334000000,9898000000,7604000000,6642000000,458000000,2418000000,2418000000
423,2020-09-30,Chubb,CB,,1336000000,1194000000,733000000,1810000000,987000000,987000000,-130000000,142000000,9488000000,8501000000,7678000000,349000000,1194000000,1194000000
424,2021-09-30,Church & Dwight,CHD,,289300000,230400000,318800000,579200000,260400000,260400000,-13400000,58900000,1311400000,1051000000,732200000,28900000,230400000,230400000
425,2021-06-30,Church & Dwight,CHD,,287300000,218300000,291500000,552200000,260700000,260700000,-14100000,69000000,1271100000,1010400000,718900000,26600000,218300000,218300000
426,2021-03-31,Church & Dwight,CHD,,291000000,220700000,267300000,550900000,283600000,283600000,-14000000,70300000,1238900000,955300000,688000000,7400000,220700000,220700000
427,2020-12-31,Church & Dwight,CHD,,176900000,150200000,388800000,557400000,168600000,168600000,-14000000,26700000,1295300000,1126700000,737900000,8300000,150200000,150200000
428,2021-06-30,Cigna,CI,,1898000000,1467000000,3000000000,5705000000,2202000000,2202000000,-278000000,422000000,43190000000,40988000000,37485000000,-304000000,1476000000,1467000000
429,2021-03-31,Cigna,CI,,1513000000,1161000000,3300000000,5732000000,1937000000,1937000000,-291000000,342000000,40972000000,39035000000,35240000000,-424000000,1171000000,1161000000
430,2020-12-31,Cigna,CI,,5378000000,4135000000,3710000000,5973000000,1768000000,1768000000,-353000000,1236000000,41879000000,40111000000,35906000000,3610000000,4142000000,4135000000
431,2020-09-30,Cigna,CI,,1804000000,1388000000,3207000000,5934000000,2234000000,2234000000,-318000000,406000000,40987000000,38753000000,35053000000,-430000000,1398000000,1388000000
432,2021-03-31,Cincinnati Financial,CINF,,768000000,620000000,,803000000,781000000,781000000,-13000000,148000000,2227000000,1446000000,1424000000,-13000000,620000000,620000000
433,2020-12-31,Cincinnati Financial,CINF,,1316000000,1049000000,,1357000000,1330000000,1330000000,-14000000,267000000,2694000000,1364000000,1337000000,-14000000,1049000000,1049000000
434,2020-09-30,Cincinnati Financial,CINF,,614000000,484000000,,652000000,627000000,627000000,-13000000,130000000,2227000000,1600000000,1575000000,-13000000,484000000,484000000
435,2020-06-30,Cincinnati Financial,CINF,,1145000000,909000000,,1189000000,1159000000,1159000000,-14000000,236000000,2714000000,1555000000,1525000000,-14000000,909000000,909000000
436,2021-08-31,Cintas Corporation,CTAS,,372303000,331179000,508655000,902756000,394101000,394101000,-21854000,41124000,1896950000,1502849000,994194000,-21798000,331179000,329414000
437,2021-05-31,Cintas Corporation,CTAS,,331993000,267722000,497490000,859050000,361560000,361560000,-24551000,64271000,1835662000,1474102000,976612000,-29567000,267722000,266007000
438,2021-02-28,Cintas Corporation,CTAS,,302003000,258384000,483048000,809516000,326468000,326468000,-24552000,43619000,1777056000,1450588000,967540000,-24465000,258384000,256490000
439,2020-11-30,Cintas Corporation,CTAS,,328533000,284857000,467012000,819884000,352872000,352872000,-24557000,43676000,1757048000,1404176000,937164000,-24339000,284857000,282842000
440,2021-05-01,Cisco Systems,CSCO,1697000000,3591000000,2863000000,2920000000,8185000000,3507000000,3507000000,-111000000,728000000,12803000000,9296000000,4618000000,84000000,2863000000,2863000000
441,2021-01-23,Cisco Systems,CSCO,1527000000,3255000000,2545000000,2761000000,7784000000,3457000000,3457000000,-113000000,710000000,11960000000,8503000000,4176000000,-202000000,2545000000,2545000000
442,2020-10-24,Cisco Systems,CSCO,1612000000,2681000000,2174000000,2757000000,7581000000,3176000000,3176000000,-112000000,507000000,11929000000,8753000000,4348000000,-495000000,2174000000,2174000000
443,2020-07-25,Cisco Systems,CSCO,1565000000,3306000000,2636000000,2704000000,7684000000,3382000000,3382000000,-119000000,670000000,12154000000,8772000000,4470000000,-76000000,2636000000,2636000000
444,2021-06-30,Citigroup,C,,7348000000,6193000000,8775000000,18596000000,0,7348000000,,1155000000,18596000000,11248000000,0,0,6193000000,5899000000
445,2021-03-31,Citigroup,C,,10309000000,7942000000,8699000000,20817000000,0,10309000000,,2332000000,20817000000,10508000000,0,0,7977000000,7584000000
446,2020-12-31,Citigroup,C,,4998000000,3979000000,8352000000,16540000000,0,4998000000,,1003000000,16540000000,11542000000,0,0,3995000000,3689000000
447,2020-09-30,Citigroup,C,,4076000000,3230000000,8299000000,15509000000,0,4076000000,,815000000,15509000000,11433000000,0,0,3261000000,2928000000
448,2021-06-30,Citizens Financial Group,CFG,,831000000,648000000,929000000,1822000000,0,831000000,,183000000,1822000000,991000000,0,0,648000000,616000000
449,2021-03-31,Citizens Financial Group,CFG,,781000000,611000000,946000000,1799000000,0,781000000,,170000000,1799000000,1018000000,0,0,611000000,588000000
450,2020-12-31,Citizens Financial Group,CFG,,571000000,456000000,935000000,1583000000,0,571000000,,115000000,1583000000,1012000000,0,0,456000000,424000000
451,2020-09-30,Citizens Financial Group,CFG,,375000000,314000000,917000000,1363000000,0,375000000,,61000000,1363000000,988000000,0,0,314000000,289000000
452,2021-06-30,Citrix Systems,CTXS,146179000,68679000,62766000,400214000,670924000,84977000,84977000,-22905000,5913000,812111000,727134000,141187000,-16298000,62766000,62766000
453,2021-03-31,Citrix Systems,CTXS,144158000,81190000,90048000,372774000,643306000,107833000,107833000,-24360000,-8858000,775766000,667933000,132460000,-26643000,90048000,90048000
454,2020-12-31,Citrix Systems,CTXS,132517000,119148000,112091000,407709000,684118000,135285000,135285000,-16361000,7057000,809656000,674371000,125538000,-16137000,112091000,112091000
455,2020-09-30,Citrix Systems,CTXS,130628000,115998000,98227000,380250000,648177000,128305000,128305000,-16639000,17771000,767170000,638865000,118993000,-12307000,98227000,98227000
456,2021-06-30,Clorox,CLX,45000000,101000000,97000000,491000000,668000000,101000000,101000000,-25000000,1000000,1802000000,1701000000,1134000000,0,100000000,97000000
457,2021-03-31,Clorox,CLX,32000000,-59000000,-61000000,440000000,774000000,295000000,295000000,-25000000,0,1781000000,1486000000,1007000000,-354000000,-59000000,-61000000
458,2020-12-31,Clorox,CLX,40000000,332000000,259000000,458000000,837000000,356000000,356000000,-24000000,71000000,1842000000,1486000000,1005000000,-24000000,261000000,259000000
459,2020-09-30,Clorox,CLX,32000000,526000000,415000000,420000000,920000000,466000000,466000000,-25000000,109000000,1916000000,1450000000,996000000,60000000,417000000,415000000
460,2021-06-30,CME Group,CME,,726100000,510300000,368500000,1176800000,674700000,674700000,-41700000,215500000,1176800000,502100000,0,51400000,510600000,510300000
461,2021-03-31,CME Group,CME,,752300000,574400000,392300000,1250800000,725100000,725100000,-41500000,177500000,1250800000,525700000,0,27200000,574800000,574400000
462,2020-12-31,CME Group,CME,,535000000,424000000,394000000,1095300000,551000000,551000000,-41700000,110200000,1095300000,544300000,0,-16000000,424800000,424000000
463,2020-09-30,CME Group,CME,,536500000,411700000,388500000,1077300000,525000000,525000000,-41700000,125000000,1077300000,552300000,0,11500000,411500000,411700000
464,2021-09-30,CMS Energy,CMS,,179000000,189000000,-40000000,591000000,300000000,300000000,-126000000,26000000,1725000000,1425000000,1134000000,-121000000,153000000,186000000
465,2021-06-30,CMS Energy,CMS,,175000000,176000000,-40000000,583000000,292000000,292000000,-125000000,22000000,1558000000,1266000000,975000000,-117000000,153000000,176000000
466,2021-03-31,CMS Energy,CMS,,350000000,349000000,-41000000,887000000,468000000,468000000,-125000000,42000000,2013000000,1545000000,1126000000,-118000000,308000000,349000000
467,2020-12-31,CMS Energy,CMS,,197000000,158000000,-28000000,728000000,380000000,380000000,-140000000,35000000,1798000000,1418000000,1070000000,-183000000,162000000,158000000
468,2021-07-02,Coca-Cola Company,KO,,3618000000,2641000000,2944000000,6342000000,3398000000,3398000000,-780000000,994000000,10129000000,6731000000,3787000000,220000000,2624000000,2641000000
469,2021-04-02,Coca-Cola Company,KO,,2763000000,2245000000,2609000000,5515000000,2906000000,2906000000,-442000000,508000000,9020000000,6114000000,3505000000,-143000000,2255000000,2245000000
470,2020-12-31,Coca-Cola Company,KO,,2361000000,1456000000,2566000000,5033000000,2445000000,2445000000,-310000000,887000000,8611000000,6166000000,3578000000,-84000000,1474000000,1456000000
471,2020-09-25,Coca-Cola Company,KO,,2181000000,1737000000,2467000000,5181000000,2714000000,2714000000,-660000000,441000000,8652000000,5938000000,3471000000,-533000000,1740000000,1737000000
472,2021-06-30,Cognizant Technology Solutions,CTSH,,696000000,512000000,881000000,1722000000,696000000,696000000,-2000000,184000000,4585000000,3889000000,2863000000,0,512000000,512000000
473,2021-03-31,Cognizant Technology Solutions,CTSH,,665000000,505000000,827000000,1637000000,669000000,669000000,-2000000,160000000,4401000000,3732000000,2764000000,-4000000,505000000,505000000
474,2020-12-31,Cognizant Technology Solutions,CTSH,,468000000,316000000,897000000,1539000000,497000000,497000000,-3000000,152000000,4184000000,3687000000,2645000000,-29000000,316000000,316000000
475,2020-09-30,Cognizant Technology Solutions,CTSH,,624000000,348000000,804000000,1617000000,675000000,675000000,-6000000,276000000,4243000000,3568000000,2626000000,-51000000,348000000,348000000
476,2021-06-30,Colgate-Palmolive,CL,,953000000,703000000,1586000000,2556000000,978000000,978000000,-25000000,212000000,4260000000,3282000000,1704000000,-25000000,741000000,703000000
477,2021-03-31,Colgate-Palmolive,CL,,957000000,681000000,1623000000,2637000000,986000000,986000000,-29000000,229000000,4344000000,3358000000,1707000000,-29000000,728000000,681000000
478,2020-12-31,Colgate-Palmolive,CL,,894000000,647000000,1654000000,2643000000,925000000,925000000,-76000000,202000000,4324000000,3399000000,1681000000,-31000000,692000000,647000000
479,2020-09-30,Colgate-Palmolive,CL,,967000000,698000000,1533000000,2540000000,1003000000,1003000000,-36000000,222000000,4153000000,3150000000,1613000000,-36000000,745000000,698000000
480,2021-06-30,Comcast,CMCSA,,5630000000,3738000000,10400000000,19290000000,5507000000,5507000000,-1093000000,2000000000,28546000000,23039000000,9256000000,123000000,3630000000,3738000000
481,2021-03-31,Comcast,CMCSA,,4411000000,3329000000,9885000000,18286000000,5039000000,5039000000,-1018000000,1119000000,27205000000,22166000000,8919000000,-628000000,3292000000,3329000000
482,2020-12-31,Comcast,CMCSA,,4416000000,3380000000,11100000000,18270000000,3918000000,3918000000,-1231000000,979000000,27708000000,23790000000,9438000000,498000000,3437000000,3380000000
483,2020-09-30,Comcast,CMCSA,,2770000000,2019000000,9571000000,16967000000,4076000000,4076000000,-1220000000,739000000,25532000000,21456000000,8565000000,-1306000000,2031000000,2019000000
484,2021-06-30,Comerica,CMA,,421000000,328000000,446000000,884000000,0,428000000,,93000000,884000000,456000000,0,-7000000,328000000,321000000
485,2021-03-31,Comerica,CMA,,448000000,350000000,442000000,895000000,0,456000000,,98000000,895000000,439000000,0,-8000000,350000000,343000000
486,2020-12-31,Comerica,CMA,,278000000,215000000,441000000,751000000,0,292000000,,63000000,751000000,459000000,0,-14000000,215000000,209000000
487,2020-09-30,Comerica,CMA,,259000000,211000000,415000000,705000000,0,272000000,,48000000,705000000,433000000,0,-13000000,211000000,203000000
488,2021-02-28,Conagra Brands,CAG,,383300000,281400000,279300000,767600000,488300000,488300000,-101000000,101600000,2771100000,2282800000,2003500000,-105000000,281700000,281400000
489,2020-11-29,Conagra Brands,CAG,,460200000,378900000,332800000,898400000,565600000,565600000,-108100000,80700000,2995200000,2429600000,2096800000,-105400000,379500000,378900000
490,2020-08-30,Conagra Brands,CAG,,416500000,329000000,270300000,820600000,550300000,550300000,-114500000,86700000,2678900000,2128600000,1858300000,-133800000,329800000,329000000
491,2020-05-31,Conagra Brands,CAG,,261100000,201400000,409000000,933000000,524000000,524000000,-126100000,59800000,3287900000,2763900000,2354900000,-262900000,201300000,201400000
492,2021-06-30,ConocoPhillips,COP,,3080000000,2091000000,156000000,5318000000,2793000000,2793000000,-220000000,989000000,9695000000,6902000000,4377000000,287000000,2091000000,2091000000
493,2021-03-31,ConocoPhillips,COP,,1714000000,982000000,274000000,4138000000,1483000000,1483000000,-226000000,732000000,9948000000,8465000000,5810000000,231000000,982000000,982000000
494,2020-12-31,ConocoPhillips,COP,,-1086000000,-772000000,188000000,1968000000,-1048000000,-1048000000,-202000000,-314000000,5577000000,6625000000,3609000000,-38000000,-772000000,-772000000
495,2020-09-30,ConocoPhillips,COP,,-512000000,-450000000,115000000,1619000000,-275000000,-275000000,-200000000,-62000000,4421000000,4696000000,2802000000,-237000000,-450000000,-450000000
496,2021-03-31,Consolidated Edison,ED,,498000000,419000000,33000000,2061000000,827000000,827000000,-227000000,78000000,3677000000,2850000000,1616000000,-329000000,420000000,419000000
497,2020-12-31,Consolidated Edison,ED,,-44000000,43000000,-79000000,1655000000,582000000,582000000,-304000000,-93000000,2960000000,2378000000,1305000000,-626000000,49000000,43000000
498,2020-09-30,Consolidated Edison,ED,,621000000,493000000,94000000,2015000000,766000000,766000000,-231000000,119000000,3333000000,2567000000,1318000000,-145000000,502000000,493000000
499,2020-06-30,Consolidated Edison,ED,,211000000,190000000,94000000,1559000000,385000000,385000000,-249000000,9000000,2719000000,2334000000,1160000000,-174000000,202000000,190000000
500,2021-08-31,Constellation Brands,STZ,,143200000,1500000,484200000,1229600000,738300000,738300000,-95800000,131300000,2371100000,1632800000,1141500000,-595100000,11900000,1500000
501,2021-05-31,Constellation Brands,STZ,,-910800000,-908100000,378400000,1121900000,744500000,744500000,-86700000,-13500000,2026500000,1282000000,904600000,-1655300000,-897300000,-908100000
502,2021-02-28,Constellation Brands,STZ,,485300000,382900000,453600000,1043300000,590100000,590100000,-89800000,94700000,1953000000,1362900000,909700000,-104800000,390600000,382900000
503,2020-11-30,Constellation Brands,STZ,,1468600000,1280900000,447000000,1316200000,864900000,864900000,-95700000,176600000,2438100000,1573200000,1121900000,603700000,1292000000,1280900000
504,2021-04-30,Copart,CPRT,,323535000,286796000,61585000,389696000,328111000,328111000,-5346000,36739000,733910000,405799000,344214000,-4576000,286796000,286796000
505,2021-01-31,Copart,CPRT,,252452000,193440000,57719000,315940000,258221000,258221000,-4849000,59012000,617031000,358810000,301091000,-5769000,193440000,193440000
506,2020-10-31,Copart,CPRT,,246815000,200285000,57216000,305810000,248594000,248594000,-5032000,46530000,592940000,344346000,287130000,-1779000,200285000,200285000
507,2020-07-31,Copart,CPRT,,201883000,165533000,12002000,217717000,205715000,205715000,-4902000,36350000,525659000,319944000,307942000,-3832000,165533000,165533000
508,2021-06-30,Corning,GLW,238000000,516000000,449000000,442000000,1309000000,596000000,596000000,-78000000,67000000,3501000000,2905000000,2192000000,-80000000,449000000,-354000000
509,2021-03-31,Corning,GLW,222000000,825000000,599000000,372000000,1156000000,530000000,530000000,-77000000,226000000,3290000000,2760000000,2134000000,295000000,599000000,575000000
510,2020-12-31,Corning,GLW,228000000,330000000,252000000,455000000,1273000000,556000000,556000000,-75000000,78000000,3350000000,2794000000,2077000000,-226000000,252000000,227000000
511,2020-09-30,Corning,GLW,213000000,450000000,427000000,447000000,1125000000,432000000,432000000,-70000000,23000000,3001000000,2569000000,1876000000,18000000,427000000,403000000
512,2021-06-30,Corteva,CTVA,293000000,1302000000,970000000,670000000,2617000000,1474000000,1474000000,-7000000,284000000,5627000000,4153000000,3010000000,-172000000,1018000000,970000000
513,2021-03-31,Corteva,CTVA,281000000,791000000,600000000,408000000,1758000000,886000000,886000000,-7000000,178000000,4178000000,3292000000,2420000000,-95000000,613000000,600000000
514,2020-12-31,Corteva,CTVA,305000000,-70000000,41000000,631000000,1095000000,-22000000,-22000000,-10000000,-169000000,3207000000,3229000000,2112000000,-48000000,99000000,41000000
515,2020-09-30,Corteva,CTVA,284000000,-507000000,-392000000,504000000,566000000,-384000000,-384000000,-11000000,-117000000,1863000000,2247000000,1297000000,-123000000,-390000000,-392000000
516,2021-08-29,Costco,COST,,2291000000,1670000000,5632000000,7942000000,2275000000,2275000000,-52000000,597000000,62675000000,60400000000,54733000000,16000000,1694000000,1670000000
517,2021-05-09,Costco,COST,,1650000000,1220000000,4189000000,5862000000,1663000000,1663000000,-40000000,417000000,45277000000,43614000000,39415000000,-13000000,1233000000,1220000000
518,2021-02-14,Costco,COST,,1319000000,951000000,4342000000,5691000000,1340000000,1340000000,-40000000,348000000,44769000000,43429000000,39078000000,-21000000,971000000,951000000
519,2020-11-22,Costco,COST,,1420000000,1166000000,4298000000,5750000000,1430000000,1430000000,-39000000,239000000,43208000000,41778000000,37458000000,-10000000,1181000000,1166000000
520,2021-06-30,Coterra,CTRA,,41304000,30464000,16837000,262146000,60088000,60088000,-12558000,10840000,411788000,351700000,149642000,-18784000,30464000,30464000
521,2021-03-31,Coterra,CTRA,,163015000,126354000,26755000,319340000,177767000,177767000,-12377000,36661000,472918000,295151000,153578000,-14752000,126354000,126354000
522,2020-12-31,Coterra,CTRA,,151853000,131206000,24534000,249079000,163244000,163244000,-10981000,20647000,413157000,249913000,164078000,-11391000,131206000,131206000
523,2020-09-30,Coterra,CTRA,,-21979000,-14961000,24262000,166115000,-7564000,-7564000,-14389000,-7018000,333294000,340858000,167179000,-14415000,-14961000,-14961000
524,2021-06-30,Crown Castle,CCI,,339000000,334000000,169000000,1089000000,512000000,512000000,-161000000,6000000,1583000000,1071000000,494000000,-173000000,333000000,334000000
525,2021-03-31,Crown Castle,CCI,,128000000,58000000,164000000,1023000000,451000000,451000000,-170000000,7000000,1485000000,1034000000,462000000,-323000000,121000000,58000000
526,2020-12-31,Crown Castle,CCI,,512000000,508000000,185000000,991000000,405000000,405000000,-168000000,4000000,1493000000,1088000000,502000000,107000000,508000000,508000000
527,2020-09-30,Crown Castle,CCI,,168000000,163000000,154000000,999000000,439000000,439000000,-168000000,5000000,1486000000,1047000000,487000000,-271000000,163000000,163000000
528,2021-09-30,CSX,CSX,,1279000000,968000000,,1760000000,1393000000,1393000000,-177000000,311000000,3292000000,1899000000,1532000000,-114000000,968000000,968000000
529,2021-06-30,CSX,CSX,,1530000000,1173000000,,1689000000,1341000000,1341000000,-181000000,357000000,2990000000,1649000000,1301000000,189000000,1173000000,1173000000
530,2021-03-31,CSX,CSX,,937000000,706000000,,1461000000,1116000000,1116000000,-184000000,231000000,2813000000,1697000000,1352000000,-179000000,706000000,706000000
531,2020-12-31,CSX,CSX,,994000000,760000000,,1583000000,1236000000,1236000000,-189000000,234000000,2825000000,1589000000,1242000000,-242000000,760000000,760000000
532,2021-07-04,Cummins,CMI,276000000,779000000,600000000,625000000,1478000000,575000000,575000000,-29000000,167000000,6111000000,5536000000,4633000000,204000000,612000000,600000000
533,2021-04-04,Cummins,CMI,260000000,783000000,603000000,550000000,1486000000,671000000,671000000,-28000000,172000000,6092000000,5421000000,4606000000,112000000,611000000,603000000
534,2020-12-31,Cummins,CMI,255000000,635000000,501000000,559000000,1405000000,540000000,540000000,-29000000,125000000,5830000000,5290000000,4425000000,95000000,510000000,501000000
535,2020-09-27,Cummins,CMI,224000000,686000000,501000000,517000000,1305000000,603000000,603000000,-25000000,182000000,5118000000,4515000000,3813000000,83000000,504000000,501000000
536,2021-06-30,CVS Health,CVS,,3735000000,2783000000,8828000000,12906000000,4078000000,4078000000,-636000000,944000000,72327000000,68249000000,59421000000,-343000000,2791000000,2783000000
537,2021-03-31,CVS Health,CVS,,2970000000,2223000000,8881000000,12202000000,3321000000,3321000000,-657000000,746000000,68800000000,65479000000,56598000000,-351000000,2224000000,2223000000
538,2020-12-31,CVS Health,CVS,,1225000000,973000000,9297000000,11709000000,2412000000,2412000000,-678000000,241000000,69306000000,66894000000,57597000000,-1187000000,984000000,973000000
539,2020-09-30,CVS Health,CVS,,1806000000,1224000000,8414000000,11516000000,3102000000,3102000000,-731000000,587000000,66852000000,63750000000,55336000000,-1296000000,1219000000,1224000000
540,2021-06-30,D. R. Horton,DHI,,1415600000,1115500000,528700000,1959200000,1430500000,1430500000,,299100000,7284600000,5854100000,5325400000,-14900000,1116500000,1115500000
541,2021-03-31,D. R. Horton,DHI,,1179900000,929500000,497800000,1682400000,1184600000,1184600000,,246000000,6446900000,5262300000,4764500000,-4700000,933900000,929500000
542,2020-12-31,D. R. Horton,DHI,,1034300000,791800000,476400000,1503400000,1027000000,1027000000,,239100000,5933400000,4906400000,4430000000,7300000,795200000,791800000
543,2020-09-30,D. R. Horton,DHI,,1056100000,829000000,490700000,1553100000,1062400000,1062400000,,224900000,6400300000,5337900000,4847200000,-6300000,831200000,829000000
544,2021-07-02,Danaher Corporation,DHR,426000000,2043000000,1785000000,1955000000,4397000000,2016000000,2016000000,-62000000,344000000,7218000000,5202000000,2821000000,27000000,1699000000,1744000000
545,2021-04-02,Danaher Corporation,DHR,380000000,2083000000,1702000000,1855000000,4282000000,2047000000,2047000000,-58000000,381000000,6858000000,4811000000,2576000000,36000000,1702000000,1661000000
546,2020-12-31,Danaher Corporation,DHR,395800000,1541500000,1240100000,1954800000,3993900000,1643300000,1643300000,-72300000,301400000,6760300000,5117000000,2766400000,-101800000,1240100000,1199400000
547,2020-10-02,Danaher Corporation,DHR,342600000,1021500000,883500000,1791900000,3642700000,1508200000,1508200000,-76700000,138000000,5883200000,4375000000,2240500000,-486700000,883500000,842400000
548,2021-05-30,Darden Restaurants,DRI,,306000000,368500000,161100000,539400000,289200000,289200000,-18800000,-63000000,2279200000,1990000000,1739800000,16800000,369000000,368500000
549,2021-02-28,Darden Restaurants,DRI,,132300000,128700000,98100000,337400000,151100000,151100000,-15200000,3100000,1733000000,1581900000,1395600000,-18800000,129200000,128700000
550,2020-11-29,Darden Restaurants,DRI,,105700000,96000000,108700000,315400000,120700000,120700000,-14600000,8800000,1656500000,1535800000,1341100000,-15000000,96900000,96000000
551,2020-08-30,Darden Restaurants,DRI,,32500000,36100000,116800000,301300000,96900000,96900000,-16600000,-4800000,1527400000,1430500000,1226100000,-64400000,37300000,36100000
552,2021-09-30,DaVita,DVA,,394458000,259754000,293095000,929730000,466173000,466173000,-71451000,74704000,2938319000,2472146000,2008589000,-71715000,319754000,259754000
553,2021-06-30,DaVita,DVA,,432340000,293820000,298091000,951233000,483453000,483453000,-71947000,81309000,2916510000,2433057000,1965277000,-51113000,351031000,293820000
554,2021-03-31,DaVita,DVA,,376756000,237403000,281426000,881671000,434544000,434544000,-65637000,85211000,2820001000,2385457000,1938330000,-57788000,291545000,237403000
555,2020-12-31,DaVita,DVA,,327371000,173773000,304519000,848441000,382436000,382436000,-59092000,73368000,2905322000,2522886000,2056881000,-55065000,254003000,173773000
556,2021-08-01,Deere & Co.,DE,394000000,2158000000,1667000000,700000000,3256000000,2203000000,2203000000,-75000000,491000000,11500000000,9297000000,8244000000,-45000000,1667000000,1667000000
557,2021-05-02,Deere & Co.,DE,377000000,2320000000,1789000000,731000000,3615000000,2560000000,2560000000,-86000000,529000000,12085000000,9525000000,8470000000,-240000000,1791000000,1789000000
558,2021-01-31,Deere & Co.,DE,366000000,1532000000,1224000000,652000000,2625000000,1787000000,1787000000,-83000000,308000000,9112000000,7325000000,6487000000,-255000000,1224000000,1224000000
559,2020-11-01,Deere & Co.,DE,388000000,1088000000,758000000,763000000,2702000000,1540000000,1540000000,-83000000,330000000,9713000000,8173000000,7011000000,-452000000,758000000,758000000
560,2021-09-30,Delta Air Lines,DAL,,1532000000,1212000000,308000000,1695000000,529000000,529000000,-314000000,320000000,9154000000,8625000000,7459000000,1003000000,1212000000,1212000000
561,2021-06-30,Delta Air Lines,DAL,,776000000,652000000,222000000,487000000,-566000000,-566000000,-338000000,124000000,7126000000,7692000000,6639000000,1342000000,652000000,652000000
562,2021-03-31,Delta Air Lines,DAL,,-1515000000,-1177000000,110000000,-1597000000,-2521000000,-2521000000,-361000000,-338000000,4150000000,6671000000,5747000000,1006000000,-1177000000,-1177000000
563,2020-12-31,Delta Air Lines,DAL,,-1108000000,-755000000,84000000,-922000000,-4297000000,-4297000000,-365000000,-353000000,3973000000,8270000000,4895000000,3189000000,-755000000,-755000000
564,2021-03-31,Dentsply Sirona,XRAY,37000000,149000000,117000000,385000000,579000000,157000000,157000000,-14000000,32000000,1027000000,870000000,448000000,-8000000,117000000,117000000
565,2020-12-31,Dentsply Sirona,XRAY,115000000,122900000,98500000,298200000,582100000,228800000,228800000,-15300000,24300000,1082300000,853500000,500200000,-105900000,98600000,98500000
566,2020-09-30,Dentsply Sirona,XRAY,115000000,66700000,53800000,340600000,474600000,115300000,115300000,-14500000,12500000,894800000,779500000,420200000,-48600000,54200000,53800000
567,2020-06-30,Dentsply Sirona,XRAY,115000000,-119900000,-95400000,279100000,176100000,-102100000,-102100000,-12300000,-24000000,490600000,592700000,314500000,-17800000,-95900000,-95400000
568,2021-06-30,Devon Energy,DVN,,304000000,256000000,94000000,1655000000,320000000,320000000,-98000000,43000000,2977000000,2657000000,1322000000,-16000000,261000000,253000000
569,2021-03-31,Devon Energy,DVN,,-32000000,213000000,107000000,1291000000,202000000,202000000,-105000000,-248000000,2461000000,2259000000,1170000000,-234000000,216000000,211000000
570,2020-12-31,Devon Energy,DVN,,-110000000,-102000000,82000000,511000000,2819000000,2819000000,-64000000,-37000000,1350000000,-1469000000,839000000,-2929000000,-73000000,-103000000
571,2020-09-30,Devon Energy,DVN,,-193000000,-92000000,75000000,409000000,-95000000,-95000000,-65000000,-90000000,1112000000,1207000000,703000000,-98000000,-103000000,-94000000
572,2021-06-30,DexCom,DXCM,129100000,76700000,62900000,187000000,417100000,101000000,101000000,-25200000,13800000,595100000,494100000,178000000,-24300000,62900000,62900000
573,2021-03-31,DexCom,DXCM,109400000,21200000,40300000,188600000,343900000,45900000,45900000,-24800000,-19100000,505000000,459100000,161100000,-24700000,40300000,40300000
574,2020-12-31,DexCom,DXCM,119200000,81300000,355200000,175900000,399100000,104000000,104000000,-24600000,-273900000,568900000,464900000,169800000,-22700000,355200000,355200000
575,2020-09-30,DexCom,DXCM,87700000,75100000,72200000,158600000,340400000,94100000,94100000,-24400000,2900000,500900000,406800000,160500000,-19000000,72200000,72200000
576,2021-03-31,Diamondback Energy,FANG,,288000000,220000000,25000000,962000000,355000000,355000000,72000000,65000000,1123000000,768000000,161000000,-67000000,223000000,220000000
577,2020-12-31,Diamondback Energy,FANG,,-958000000,-739000000,24000000,577000000,48000000,48000000,72000000,-202000000,729000000,681000000,152000000,-1006000000,-756000000,-739000000
578,2020-09-30,Diamondback Energy,FANG,,-1409000000,-1113000000,20000000,522000000,91000000,91000000,-48000000,-304000000,683000000,592000000,161000000,-1500000000,-1105000000,-1113000000
579,2020-06-30,Diamondback Energy,FANG,,-3092000000,-2393000000,20000000,233000000,-486000000,-486000000,-54000000,-681000000,404000000,890000000,171000000,-2606000000,-2411000000,-2393000000
580,2021-06-30,Digital Realty Trust,DLR,,173380000,121254000,97492000,713617000,244846000,244846000,-75014000,47582000,1145331000,900485000,431714000,-71466000,125798000,127369000
581,2021-03-31,Digital Realty Trust,DLR,,402223000,385920000,99994000,638958000,169488000,169488000,-75653000,7547000,1067360000,897872000,428402000,232735000,394676000,372406000
582,2020-12-31,Digital Realty Trust,DLR,,62830000,57691000,178188000,673352000,210608000,210608000,-77883000,3322000,1093664000,883056000,420312000,-147778000,59508000,44177000
583,2020-09-30,Digital Realty Trust,DLR,,14599000,-138000,91352000,621274000,163782000,163782000,-89499000,16053000,1022612000,858830000,401338000,-149183000,-1454000,-37370000
584,2021-06-30,Discover Financial Services,DFS,,2222000000,1698000000,882000000,3299000000,0,2314000000,,524000000,3444000000,1130000000,145000000,-92000000,1698000000,1688000000
585,2021-03-31,Discover Financial Services,DFS,,2079000000,1593000000,866000000,3051000000,0,2079000000,,486000000,3160000000,1081000000,109000000,0,1593000000,1546000000
586,2020-12-31,Discover Financial Services,DFS,,1015000000,799000000,885000000,2095000000,0,1111000000,,216000000,2293000000,1182000000,198000000,-96000000,799000000,795000000
587,2020-09-30,Discover Financial Services,DFS,,959000000,771000000,788000000,1853000000,0,959000000,,188000000,1964000000,1005000000,111000000,0,771000000,751000000
588,2021-03-31,Discovery (Series A),DISCA,,297000000,140000000,1047000000,1823000000,415000000,415000000,-173000000,106000000,2792000000,2377000000,969000000,-118000000,191000000,125000000
589,2020-12-31,Discovery (Series A),DISCA,,416000000,271000000,803000000,1797000000,636000000,636000000,-173000000,98000000,2886000000,2250000000,1089000000,-220000000,318000000,245000000
590,2020-09-30,Discovery (Series A),DISCA,,319000000,300000000,633000000,1559000000,585000000,585000000,-171000000,-11000000,2561000000,1976000000,1002000000,-266000000,330000000,265000000
591,2020-06-30,Discovery (Series A),DISCA,,456000000,271000000,635000000,1737000000,768000000,768000000,-172000000,156000000,2541000000,1773000000,804000000,-312000000,300000000,243000000
592,2021-03-31,Discovery (Series C),DISCK,,297000000,140000000,1047000000,1823000000,415000000,415000000,-173000000,106000000,2792000000,2377000000,969000000,-118000000,191000000,125000000
593,2020-12-31,Discovery (Series C),DISCK,,416000000,271000000,803000000,1797000000,636000000,636000000,-173000000,98000000,2886000000,2250000000,1089000000,-220000000,318000000,245000000
594,2020-09-30,Discovery (Series C),DISCK,,319000000,300000000,633000000,1559000000,585000000,585000000,-171000000,-11000000,2561000000,1976000000,1002000000,-266000000,330000000,265000000
595,2020-06-30,Discovery (Series C),DISCK,,456000000,271000000,635000000,1737000000,768000000,768000000,-172000000,156000000,2541000000,1773000000,804000000,-312000000,300000000,243000000
596,2021-06-30,Dish Network,DISH,,898989000,671047000,507909000,1601037000,906738000,906738000,-3825000,217538000,4486960000,3580222000,2885923000,-7749000,681451000,671047000
597,2021-03-31,Dish Network,DISH,,857412000,630224000,481686000,1536647000,864576000,864576000,-3873000,215849000,4497853000,3633277000,2961206000,-7164000,641563000,630224000
598,2020-12-31,Dish Network,DISH,,989709000,732632000,429261000,1615425000,989639000,989639000,-3873000,228411000,4557365000,3567726000,2941940000,70000,761298000,732632000
599,2020-09-30,Dish Network,DISH,,806473000,504599000,516648000,1526979000,811248000,811248000,6778000,273514000,4531591000,3720343000,3004612000,-4775000,532959000,504599000
600,2021-04-30,Dollar General,DG,,868458000,677749000,1846818000,2755668000,908850000,908850000,-40392000,190709000,8400964000,7492114000,5645296000,-40392000,677749000,677749000
601,2021-01-29,Dollar General,DG,,831956000,642743000,1861771000,2736695000,874924000,874924000,-40268000,189213000,8414524000,7539600000,5677829000,-42968000,642743000,642743000
602,2020-10-30,Dollar General,DG,,732832000,574260000,1795110000,2568240000,773130000,773130000,-40298000,158572000,8199625000,7426495000,5631385000,-40298000,574260000,574260000
603,2020-07-31,Dollar General,DG,,1003301000,787601000,1775608000,2818235000,1042627000,1042627000,-39326000,215700000,8684241000,7641614000,5866006000,-39326000,787601000,787601000
604,2021-05-01,Dollar Tree,DLTR,,486900000,374500000,1447100000,1967000000,519900000,519900000,-33000000,112400000,6479700000,5959800000,4512700000,-33000000,374500000,374500000
605,2021-01-30,Dollar Tree,DLTR,,647400000,502800000,1394200000,2160400000,718100000,718100000,-34200000,144600000,6767900000,6049800000,4607500000,-70700000,502800000,502800000
606,2020-10-31,Dollar Tree,DLTR,,427300000,330000000,1423500000,1935300000,511800000,511800000,-38100000,97300000,6177000000,5665200000,4241700000,-84500000,330000000,330000000
607,2020-08-01,Dollar Tree,DLTR,,339900000,261500000,1419100000,1927600000,508500000,508500000,-34800000,78400000,6277600000,5769100000,4350000000,-168600000,261500000,261500000
608,2021-06-30,Dominion Energy,D,,222000000,285000000,-114000000,1510000000,786000000,786000000,-518000000,-47000000,3038000000,2252000000,1528000000,-564000000,269000000,269000000
609,2021-03-31,Dominion Energy,D,,1192000000,1008000000,-124000000,1886000000,1257000000,1257000000,-53000000,212000000,3870000000,2613000000,1984000000,-65000000,980000000,992000000
610,2020-12-31,Dominion Energy,D,,1021000000,682000000,-486000000,1762000000,750000000,750000000,-272000000,206000000,3521000000,2771000000,1759000000,271000000,815000000,665000000
611,2020-09-30,Dominion Energy,D,,2000000,356000000,31000000,1998000000,951000000,951000000,-306000000,-110000000,3607000000,2656000000,1609000000,-949000000,112000000,340000000
612,2021-06-20,Domino's Pizza,DPZ,,145093000,116619000,100448000,291350000,190902000,190902000,-45877000,28474000,1032472000,841570000,741122000,-45809000,116619000,116619000
613,2021-03-28,Domino's Pizza,DPZ,,149638000,117761000,91253000,277791000,186538000,186538000,-39422000,31877000,983698000,797160000,705907000,-36900000,117761000,117761000
614,2021-01-03,Domino's Pizza,DPZ,,189565000,151897000,138404000,382448000,244044000,244044000,-54479000,37668000,1356567000,1112523000,974119000,-54479000,151897000,151897000
615,2020-09-06,Domino's Pizza,DPZ,,123773000,99129000,91652000,253833000,162181000,162181000,-38605000,24644000,967719000,805538000,713886000,-38408000,99129000,99129000
616,2021-09-30,Dover Corporation,DOV,34400000,327519000,263756000,374239000,756773000,348134000,348134000,-26433000,63763000,2018269000,1670135000,1261496000,-20615000,263756000,263756000
617,2021-06-30,Dover Corporation,DOV,41200000,323344000,264508000,380932000,777011000,354879000,354879000,-26661000,58836000,2031676000,1676797000,1254665000,-31535000,264508000,264508000
618,2021-03-31,Dover Corporation,DOV,41200000,289250000,232769000,363954000,725455000,320301000,320301000,-26823000,56481000,1867901000,1547600000,1142446000,-31051000,232769000,232769000
619,2020-12-31,Dover Corporation,DOV,142101000,220408000,182106000,250888000,658535000,265546000,265546000,-28234000,38302000,1780390000,1514844000,1121855000,-45138000,182106000,182106000
620,2021-06-30,Dow,DOW,228000000,2456000000,1901000000,354000000,3247000000,2565000000,2565000000,-187000000,524000000,13885000000,11320000000,10638000000,-109000000,1932000000,1891000000
621,2021-03-31,Dow,DOW,194000000,1323000000,991000000,291000000,1820000000,1234000000,1234000000,-196000000,317000000,11882000000,10648000000,10062000000,89000000,1006000000,986000000
622,2020-12-31,Dow,DOW,214000000,1816000000,1236000000,405000000,1567000000,847000000,847000000,-210000000,562000000,10706000000,9859000000,9139000000,969000000,1254000000,1236000000
623,2020-09-30,Dow,DOW,193000000,42000000,-25000000,346000000,1341000000,702000000,702000000,-202000000,43000000,9712000000,9010000000,8371000000,-660000000,-1000000,-28000000
624,2021-06-30,DTE Energy,DTE,,201000000,179000000,3000000,885000000,388000000,388000000,-190000000,22000000,3229000000,2841000000,2344000000,-187000000,179000000,178000000
625,2021-03-31,DTE Energy,DTE,,425000000,397000000,4000000,1026000000,532000000,532000000,-181000000,28000000,3778000000,3246000000,2752000000,-107000000,397000000,397000000
626,2020-12-31,DTE Energy,DTE,,324000000,275000000,8000000,949000000,453000000,453000000,-188000000,49000000,3288000000,2835000000,2339000000,-129000000,275000000,275000000
627,2020-09-30,DTE Energy,DTE,,540000000,476000000,5000000,1061000000,597000000,597000000,-178000000,63000000,3284000000,2687000000,2223000000,-57000000,477000000,475000000
628,2021-06-30,Duke Energy,DUK,,734000000,765000000,,2854000000,1298000000,1298000000,-572000000,36000000,5758000000,4460000000,2904000000,-564000000,698000000,738000000
629,2021-03-31,Duke Energy,DUK,,1025000000,992000000,,3029000000,1450000000,1450000000,-535000000,84000000,6150000000,4700000000,3121000000,-425000000,941000000,964000000
630,2020-12-31,Duke Energy,DUK,,-319000000,-63000000,,2564000000,1022000000,1022000000,-535000000,-162000000,5777000000,4755000000,3213000000,-1341000000,-157000000,-77000000
631,2020-09-30,Duke Energy,DUK,,1339000000,1304000000,,3420000000,1879000000,1879000000,-522000000,105000000,6721000000,4842000000,3301000000,-540000000,1234000000,1276000000
632,2021-03-31,Duke Realty Corp,DRE,,85388000,79362000,24217000,193897000,72004000,72004000,-22507000,5184000,292660000,220656000,98763000,13384000,80204000,78991000
633,2020-12-31,Duke Realty Corp,DRE,,166418000,168816000,13196000,194057000,83053000,83053000,-24048000,-3946000,269241000,186188000,75184000,83365000,170364000,168433000
634,2020-09-30,Duke Realty Corp,DRE,,71520000,71823000,11439000,183094000,77229000,77229000,-23059000,-956000,264956000,187727000,81862000,-5709000,72476000,71471000
635,2020-06-30,Duke Realty Corp,DRE,,40047000,39820000,11506000,176515000,72725000,72725000,-22841000,-150000,241241000,168516000,64726000,-32678000,40197000,39464000
636,2021-06-30,DuPont,DD,148000000,715000000,478000000,446000000,1480000000,719000000,719000000,-129000000,151000000,4135000000,3416000000,2655000000,-4000000,564000000,478000000
637,2021-03-31,DuPont,DD,156000000,573000000,5394000000,444000000,1464000000,697000000,697000000,-146000000,32000000,3976000000,3279000000,2512000000,-124000000,541000000,5394000000
638,2020-12-31,DuPont,DD,216000000,156000000,222000000,529000000,1731000000,458000000,458000000,-194000000,-123000000,5252000000,4794000000,3521000000,-302000000,279000000,222000000
639,2020-09-30,DuPont,DD,199000000,20000000,-79000000,519000000,1704000000,456000000,456000000,-197000000,92000000,5096000000,4640000000,3392000000,-436000000,-72000000,-79000000
640,2021-06-30,DXC Technology,DXC,,424000000,278000000,277000000,886000000,187000000,187000000,-62000000,142000000,4141000000,3954000000,3255000000,237000000,282000000,278000000
641,2021-03-31,DXC Technology,DXC,,-793000000,-798000000,832000000,1016000000,-294000000,-294000000,-77000000,11000000,4385000000,4679000000,3369000000,-499000000,-804000000,-798000000
642,2020-12-31,DXC Technology,DXC,,1978000000,1098000000,318000000,955000000,162000000,162000000,-82000000,875000000,4288000000,4126000000,3333000000,1816000000,1103000000,1098000000
643,2020-09-30,DXC Technology,DXC,,-306000000,-244000000,339000000,991000000,127000000,127000000,-96000000,-60000000,4554000000,4427000000,3563000000,-433000000,-246000000,-244000000
644,2021-06-30,Eastman Chemical,EMN,63000000,-107000000,-146000000,165000000,681000000,453000000,453000000,-51000000,37000000,2653000000,2200000000,1972000000,-560000000,-144000000,-146000000
645,2021-03-31,Eastman Chemical,EMN,58000000,339000000,274000000,148000000,602000000,396000000,396000000,-51000000,62000000,2409000000,2013000000,1807000000,-57000000,277000000,274000000
646,2020-12-31,Eastman Chemical,EMN,57000000,25000000,32000000,383000000,527000000,87000000,87000000,-52000000,-9000000,2186000000,2099000000,1659000000,-62000000,34000000,32000000
647,2020-09-30,Eastman Chemical,EMN,56000000,190000000,161000000,135000000,508000000,317000000,317000000,-54000000,25000000,2122000000,1805000000,1614000000,-127000000,165000000,161000000
648,2021-06-30,Eaton Corporation,ETN,154000000,620000000,506000000,860000000,1670000000,656000000,656000000,-123000000,114000000,5215000000,4559000000,3545000000,-36000000,506000000,506000000
649,2021-03-31,Eaton Corporation,ETN,148000000,538000000,458000000,780000000,1508000000,580000000,580000000,-123000000,79000000,4692000000,4112000000,3184000000,-42000000,459000000,458000000
650,2020-12-31,Eaton Corporation,ETN,140000000,553000000,475000000,773000000,1509000000,596000000,596000000,-162000000,77000000,4687000000,4091000000,3178000000,-43000000,476000000,475000000
651,2020-09-30,Eaton Corporation,ETN,132000000,525000000,446000000,760000000,1475000000,583000000,583000000,-90000000,78000000,4526000000,3943000000,3051000000,-58000000,447000000,446000000
652,2021-06-30,eBay,EBAY,350000000,401000000,10734000000,809000000,1996000000,732000000,732000000,-58000000,107000000,2668000000,1936000000,672000000,-331000000,294000000,10734000000
653,2021-03-31,eBay,EBAY,304000000,724000000,641000000,757000000,2032000000,876000000,876000000,-67000000,156000000,2638000000,1762000000,606000000,-152000000,568000000,641000000
654,2020-12-31,eBay,EBAY,299000000,1109000000,845000000,1057000000,2126000000,677000000,677000000,-94000000,328000000,2868000000,2191000000,742000000,432000000,781000000,845000000
655,2020-09-30,eBay,EBAY,287000000,774000000,664000000,918000000,1950000000,679000000,679000000,-67000000,153000000,2606000000,1927000000,656000000,95000000,621000000,664000000
656,2021-06-30,Ecolab,ECL,,399700000,310800000,836200000,1322400000,486200000,486200000,-51700000,86100000,3162700000,2676500000,1840300000,-86500000,313600000,310800000
657,2021-03-31,Ecolab,ECL,,262600000,193600000,845900000,1192600000,346700000,346700000,-53800000,66100000,2885000000,2538300000,1692400000,-67100000,196500000,193600000
658,2020-12-31,Ecolab,ECL,,378000000,300300000,794600000,1287600000,493000000,493000000,-51400000,73100000,3065300000,2572300000,1777700000,-115000000,304900000,300300000
659,2020-09-30,Ecolab,ECL,,291700000,246200000,787500000,1258500000,471000000,471000000,-55900000,42400000,3018600000,2547600000,1760100000,-179300000,249300000,246200000
660,2021-06-30,Edison International,EIX,,386000000,318000000,-33000000,1278000000,672000000,672000000,-275000000,68000000,3315000000,2643000000,2037000000,-286000000,318000000,318000000
661,2021-03-31,Edison International,EIX,,223000000,259000000,-33000000,1103000000,485000000,485000000,-248000000,-36000000,2960000000,2475000000,1857000000,-262000000,259000000,259000000
662,2020-12-31,Edison International,EIX,,576000000,526000000,366000000,1698000000,788000000,788000000,-252000000,50000000,3157000000,2369000000,1459000000,-212000000,526000000,526000000
663,2020-09-30,Edison International,EIX,,-563000000,-288000000,694000000,2301000000,1031000000,1031000000,-268000000,-275000000,4644000000,3613000000,2343000000,-1594000000,-288000000,-288000000
664,2021-06-30,Edwards Lifesciences,EW,225300000,545500000,489500000,374500000,1041700000,441900000,441900000,-2500000,56000000,1376000000,934100000,334300000,103600000,489500000,489500000
665,2021-03-31,Edwards Lifesciences,EW,207000000,389300000,338200000,330800000,923200000,385400000,385400000,-2500000,51100000,1216600000,831200000,293400000,3900000,338200000,338200000
666,2020-12-31,Edwards Lifesciences,EW,195700000,356100000,309500000,338900000,895400000,360800000,360800000,-15800000,46600000,1191700000,830900000,296300000,-4700000,309500000,309500000
667,2020-09-30,Edwards Lifesciences,EW,195500000,364300000,325200000,307200000,859900000,357200000,357200000,-800000,39100000,1140900000,783700000,281000000,7100000,325200000,325200000
668,2021-06-30,Electronic Arts,EA,515000000,308000000,204000000,348000000,1236000000,345000000,345000000,-14000000,104000000,1551000000,1206000000,315000000,-37000000,204000000,204000000
669,2021-03-31,Electronic Arts,EA,468000000,165000000,76000000,361000000,1027000000,184000000,184000000,-22000000,89000000,1346000000,1162000000,319000000,-19000000,76000000,76000000
670,2020-12-31,Electronic Arts,EA,451000000,245000000,211000000,365000000,1072000000,251000000,251000000,-11000000,34000000,1673000000,1422000000,601000000,-6000000,211000000,211000000
671,2020-09-30,Electronic Arts,EA,421000000,139000000,185000000,289000000,865000000,149000000,149000000,-11000000,-46000000,1151000000,1002000000,286000000,-10000000,185000000,185000000
672,2021-03-31,Eli Lilly & Co,LLY,1684800000,1476400000,1355300000,1502600000,4927000000,1739600000,1739600000,-87800000,121100000,6805600000,5066000000,1878600000,-263200000,1355300000,1355300000
673,2020-12-31,Eli Lilly & Co,LLY,1838000000,2469100000,2116800000,1496600000,5720200000,2385600000,2385600000,-89200000,352300000,7440000000,5054400000,1719800000,83500000,2116800000,2116800000
674,2020-09-30,Eli Lilly & Co,LLY,1465400000,1437200000,1208400000,1455100000,4414200000,1493700000,1493700000,-89600000,228800000,5740600000,4246900000,1326400000,-56500000,1208400000,1208400000
675,2020-06-30,Eli Lilly & Co,LLY,1390200000,1643700000,1412000000,1412700000,4277400000,1474500000,1474500000,-88300000,231700000,5499400000,4024900000,1222000000,169200000,1412000000,1412000000
676,2021-06-30,Emerson Electric Company,EMR,,784000000,627000000,1073000000,1982000000,841000000,841000000,-40000000,151000000,4697000000,3856000000,2715000000,-57000000,633000000,627000000
677,2021-03-31,Emerson Electric Company,EMR,,737000000,561000000,1054000000,1862000000,783000000,783000000,-42000000,169000000,4431000000,3648000000,2569000000,-46000000,568000000,561000000
678,2020-12-31,Emerson Electric Company,EMR,,563000000,445000000,998000000,1723000000,644000000,644000000,-42000000,111000000,4161000000,3517000000,2438000000,-81000000,452000000,445000000
679,2020-09-30,Emerson Electric Company,EMR,,765000000,723000000,946000000,1887000000,926000000,926000000,-43000000,35000000,4558000000,3632000000,2671000000,-161000000,730000000,723000000
680,2021-03-31,Enphase Energy,ENPH,21818000,-1666000,31698000,36645000,122949000,64486000,64486000,-7329000,-33364000,301754000,237268000,178805000,-66152000,31698000,31698000
681,2020-12-31,Enphase Energy,ENPH,15801000,71352000,72991000,27023000,121938000,79114000,79114000,-5901000,-1639000,264839000,185725000,142901000,-7762000,72991000,72991000
682,2020-09-30,Enphase Energy,ENPH,15052000,44845000,39362000,28170000,94981000,51759000,51759000,-5993000,5483000,178503000,126744000,83522000,-6914000,39362000,39362000
683,2020-06-30,Enphase Energy,ENPH,13192000,-53855000,-47294000,24341000,48387000,10854000,10854000,-5952000,-6561000,125538000,114684000,77151000,-64709000,-47294000,-47294000
684,2021-06-30,Entergy,ETR,,-24390000,-5974000,145691000,1118817000,364609000,364609000,-224968000,-18416000,2822070000,2457461000,1703253000,-388999000,-5974000,-5974000
685,2021-03-31,Entergy,ETR,,400507000,334565000,31739000,1213412000,479531000,479531000,-210514000,65942000,2844838000,2365307000,1631426000,-79024000,334565000,334565000
686,2020-12-31,Entergy,ETR,,99096000,387968000,-165327000,968432000,398729000,398729000,-212411000,-288872000,2370102000,1971373000,1401670000,-299633000,387968000,387968000
687,2020-09-30,Entergy,ETR,,670563000,521119000,76341000,1421255000,706136000,706136000,-212439000,149444000,2903568000,2197432000,1482313000,-35573000,521119000,521119000
688,2021-06-30,EOG Resources,EOG,,1124000000,907000000,120000000,2912000000,1121000000,1121000000,-45000000,217000000,4515000000,3394000000,1603000000,3000000,907000000,907000000
689,2021-03-31,EOG Resources,EOG,,881000000,677000000,110000000,2618000000,939000000,939000000,-47000000,204000000,4067000000,3128000000,1449000000,-58000000,677000000,677000000
690,2020-12-31,EOG Resources,EOG,,427760000,337466000,113235000,1704077000,852826000,852826000,-53121000,90294000,2901794000,2048968000,1197717000,-425066000,337466000,337466000
691,2020-09-30,EOG Resources,EOG,,-52555000,-42467000,124460000,1276567000,68262000,68262000,-53242000,-10088000,2320438000,2252176000,1043871000,-120817000,-42467000,-42467000
692,2021-06-30,Equifax,EFX,,277100000,215100000,328400000,751800000,306000000,306000000,-34900000,61200000,1234800000,928800000,483000000,-28900000,215900000,215100000
693,2021-03-31,Equifax,EFX,,268500000,201600000,308800000,729700000,306600000,306600000,-37200000,65600000,1213000000,906400000,483300000,-38100000,202900000,201600000
694,2020-12-31,Equifax,EFX,,111600000,87400000,344400000,637500000,191600000,191600000,-36900000,21000000,1118400000,926800000,480900000,-80000000,90600000,87400000
695,2020-09-30,Equifax,EFX,,300400000,224200000,332000000,635100000,202400000,202400000,-37400000,75400000,1068300000,865900000,433200000,98000000,225000000,224200000
696,2021-06-30,Equinix,EQIX,,49960000,68339000,507615000,792799000,285184000,285184000,-87231000,-18527000,1657919000,1372735000,865120000,-235224000,68487000,68339000
697,2021-03-31,Equinix,EQIX,,188702000,156362000,484283000,784847000,300564000,300564000,-89681000,32628000,1596064000,1295500000,811217000,-111862000,156074000,156362000
698,2020-12-31,Equinix,EQIX,,92240000,50994000,480199000,741170000,260971000,260971000,-90912000,41304000,1571905000,1310934000,830735000,-168731000,50936000,50994000
699,2020-09-30,Equinix,EQIX,,96734000,66687000,452077000,749314000,297237000,297237000,-99736000,29903000,1517293000,1220056000,767979000,-200503000,66831000,66687000
700,2021-06-30,Equity Residential,EQR,,328282000,316386000,14678000,368457000,153106000,153106000,-69063000,242000,598059000,444953000,229602000,175176000,328040000,315614000
701,2021-03-31,Equity Residential,EQR,,60517000,57539000,15383000,350948000,135603000,135603000,-69543000,153000,597602000,461999000,246654000,-75086000,60364000,56766000
702,2020-12-31,Equity Residential,EQR,,263334000,252856000,11093000,389939000,177017000,177017000,-119410000,350000,613435000,436418000,223496000,86317000,262984000,252084000
703,2020-09-30,Equity Residential,EQR,,95627000,91286000,10859000,393899000,182435000,182435000,-82975000,262000,622433000,439998000,228534000,-86808000,95365000,90513000
704,2021-06-30,Essex Property Trust,ESS,,69615000,64846000,12222000,252587000,111629000,111629000,-50971000,0,369226000,257597000,116639000,-42014000,69615000,64846000
705,2021-03-31,Essex Property Trust,ESS,,176949000,168444000,9812000,252695000,114296000,114296000,-51649000,0,372136000,257840000,119441000,62653000,176949000,168444000
706,2020-12-31,Essex Property Trust,ESS,,101649000,95745000,23144000,253071000,99800000,99800000,-55609000,0,369733000,269933000,116662000,1849000,101649000,95745000
707,2020-09-30,Essex Property Trust,ESS,,78842000,73661000,13310000,264755000,121243000,121243000,-55430000,0,385771000,264528000,121016000,-42401000,78842000,73661000
708,2021-06-30,Estée Lauder Companies,EL,,1050000000,1018000000,2604000000,2951000000,347000000,347000000,-42000000,35000000,3936000000,3589000000,985000000,703000000,1015000000,1018000000
709,2021-03-31,Estée Lauder Companies,EL,,580000000,456000000,2050000000,2929000000,879000000,879000000,-43000000,122000000,3864000000,2985000000,935000000,-299000000,458000000,456000000
710,2020-12-31,Estée Lauder Companies,EL,,1030000000,873000000,2599000000,3771000000,1172000000,1172000000,-43000000,153000000,4853000000,3681000000,1082000000,-142000000,877000000,873000000
711,2020-09-30,Estée Lauder Companies,EL,,671000000,523000000,2029000000,2740000000,711000000,711000000,-45000000,146000000,3562000000,2851000000,822000000,-40000000,525000000,523000000
712,2021-06-30,Etsy,ETSY,61753000,85754000,98254000,219129000,379931000,99049000,99049000,-1882000,-12500000,528900000,429851000,148969000,-13295000,98254000,98254000
713,2021-03-31,Etsy,ETSY,53706000,157728000,143766000,203386000,407729000,150637000,150637000,-1685000,13962000,550646000,400009000,142917000,7091000,143766000,143766000
714,2020-12-31,Etsy,ETSY,51157000,153307000,148538000,253980000,466575000,161438000,161438000,-11417000,4769000,617355000,455917000,150780000,-8131000,148538000,148538000
715,2020-09-30,Etsy,ETSY,45908000,90393000,91761000,166841000,331310000,118561000,118561000,-10615000,-1368000,451478000,332917000,120168000,-28168000,91761000,91761000
716,2021-06-30,Everest Re,RE,,760181000,679982000,16168000,791956000,775788000,775788000,-15607000,80199000,3076690000,2300902000,2284734000,-15607000,679982000,679982000
717,2021-03-31,Everest Re,RE,,373095000,341862000,12378000,349312000,336934000,336934000,-15639000,31233000,2691973000,2355039000,2342661000,36161000,341862000,337446000
718,2020-12-31,Everest Re,RE,,119396000,63602000,11934000,191376000,179442000,179442000,-14846000,55794000,2806599000,2627157000,2615223000,-60046000,63602000,62893000
719,2020-09-30,Everest Re,RE,,272508000,243057000,10618000,228367000,217749000,217749000,-6641000,29451000,2548784000,2331035000,2320417000,54759000,243057000,240138000
720,2021-06-30,Evergy,EVRG,,207900000,185300000,,618400000,295300000,295300000,-93800000,19600000,1236200000,940900000,617800000,-87400000,188300000,185300000
721,2021-03-31,Evergy,EVRG,,217600000,191600000,14800000,639000000,310000000,310000000,-94000000,23000000,1611900000,1301900000,972900000,-92400000,194600000,191600000
722,2020-12-31,Evergy,EVRG,,62400000,51000000,14900000,476000000,149100000,149100000,-93400000,8400000,1094400000,945300000,618400000,-86700000,54000000,51000000
723,2020-09-30,Evergy,EVRG,,417500000,364500000,13700000,859400000,536700000,536700000,-94800000,50000000,1517600000,980900000,658200000,-119200000,367500000,364500000
724,2021-06-30,Eversource Energy,ES,,352789000,264520000,-22100000,1061304000,473705000,473705000,-145435000,86389000,2122538000,1648833000,1061234000,-120916000,266400000,264520000
725,2021-03-31,Eversource Energy,ES,,482003000,366143000,-20100000,1361807000,605668000,605668000,-137766000,113980000,2825840000,2220172000,1464033000,-123665000,368023000,366143000
726,2020-12-31,Eversource Energy,ES,,344368000,271923000,-10100000,1087446000,467328000,467328000,-135385000,70565000,2233933000,1766605000,1146487000,-122960000,273803000,271923000
727,2020-09-30,Eversource Energy,ES,,456382000,346260000,-11000000,1207257000,574130000,574130000,-134066000,108242000,2343642000,1769512000,1136385000,-117748000,348140000,346260000
728,2021-03-31,Exelon,EXC,,-283000000,-289000000,-20000000,1943000000,502000000,502000000,-386000000,-19000000,9890000000,9388000000,7947000000,-785000000,-264000000,-289000000
729,2020-12-31,Exelon,EXC,,667000000,359000000,-15000000,2259000000,844000000,844000000,-394000000,232000000,8114000000,7270000000,5855000000,-177000000,435000000,359000000
730,2020-09-30,Exelon,EXC,,785000000,501000000,-15000000,3132000000,1674000000,1674000000,-404000000,216000000,8853000000,7179000000,5721000000,-889000000,569000000,501000000
731,2020-06-30,Exelon,EXC,,793000000,521000000,-13000000,1966000000,567000000,567000000,-427000000,219000000,7325000000,6758000000,5359000000,226000000,574000000,521000000
732,2021-03-31,Expedia Group,EXPE,247000000,-750000000,-578000000,820000000,935000000,-341000000,-341000000,-98000000,-169000000,1246000000,1587000000,311000000,-409000000,-581000000,-606000000
733,2020-12-31,Expedia Group,EXPE,223000000,-495000000,-383000000,635000000,633000000,-423000000,-423000000,-102000000,-104000000,920000000,1343000000,287000000,-72000000,-391000000,-412000000
734,2020-09-30,Expedia Group,EXPE,224000000,-224000000,-192000000,663000000,1129000000,20000000,20000000,-113000000,-24000000,1504000000,1484000000,375000000,-244000000,-200000000,-221000000
735,2020-06-30,Expedia Group,EXPE,255000000,-953000000,-736000000,448000000,177000000,-758000000,-758000000,-95000000,-213000000,566000000,1324000000,389000000,-195000000,-740000000,-753000000
736,2021-03-31,Expeditors,EXPD,,390461000,287220000,3070000,454151000,385515000,385515000,,102511000,3357540000,2972025000,2903389000,4946000,287950000,287220000
737,2020-12-31,Expeditors,EXPD,,283907000,198620000,4135000,357761000,281811000,281811000,,84382000,3169188000,2887377000,2811427000,2096000,199525000,198620000
738,2020-09-30,Expeditors,EXPD,,254429000,191307000,2945000,318282000,251945000,251945000,,62710000,2464797000,2212852000,2146515000,2484000,191719000,191307000
739,2020-06-30,Expeditors,EXPD,,250982000,183869000,3113000,313109000,247626000,247626000,,66794000,2580632000,2333006000,2267523000,3356000,184188000,183869000
740,2021-06-30,Extra Space Storage,EXR,,184000000,167948000,26341000,297313000,211402000,211402000,-40240000,5421000,393203000,181801000,95890000,-27402000,178579000,167716000
741,2021-03-31,Extra Space Storage,EXR,,219638000,202998000,23540000,266285000,184146000,184146000,-40695000,4137000,365813000,181667000,99528000,35492000,215501000,202686000
742,2020-12-31,Extra Space Storage,EXR,,170106000,156056000,52688000,293770000,184343000,184343000,-41016000,3797000,360159000,175816000,66389000,-14237000,166309000,155863000
743,2020-09-30,Extra Space Storage,EXR,,128511000,114633000,23894000,249118000,168812000,168812000,-43446000,4657000,348629000,179817000,99511000,-40301000,123854000,114456000
744,2021-06-30,ExxonMobil,XOM,,6307000000,4690000000,2497000000,20506000000,5135000000,5135000000,-254000000,1526000000,66306000000,61171000000,45800000000,1172000000,4781000000,4690000000
745,2021-03-31,ExxonMobil,XOM,,3592000000,2730000000,2767000000,17011000000,3027000000,3027000000,-258000000,796000000,57674000000,54647000000,40663000000,565000000,2796000000,2730000000
746,2020-12-31,ExxonMobil,XOM,,-26613000000,-20070000000,2187000000,15973000000,-1176000000,-1176000000,-313000000,-6010000000,46203000000,47379000000,30230000000,-25437000000,-20603000000,-20070000000
747,2020-09-30,ExxonMobil,XOM,,-372000000,-680000000,2716000000,14643000000,-596000000,-596000000,-279000000,337000000,45696000000,46292000000,31053000000,224000000,-709000000,-680000000
748,2021-03-31,F5 Networks,FFIV,130608000,52124000,43241000,296256000,521090000,94226000,94226000,,8883000,645287000,551061000,124197000,-42102000,43241000,43241000
749,2020-12-31,F5 Networks,FFIV,114191000,117065000,87678000,274999000,509638000,120448000,120448000,,29387000,624617000,504169000,114979000,-3383000,87678000,87678000
750,2020-09-30,F5 Networks,FFIV,120300000,97523000,77663000,283936000,502849000,98613000,98613000,,19860000,614816000,516203000,111967000,-1090000,77663000,77663000
751,2020-06-30,F5 Networks,FFIV,115991000,87762000,69872000,273600000,477212000,87621000,87621000,,17890000,583252000,495631000,106040000,141000,69872000,69872000
752,2021-06-30,Facebook,FB,6096000000,12513000000,10394000000,5215000000,23678000000,12367000000,12367000000,,2119000000,29077000000,16710000000,5399000000,146000000,10394000000,10394000000
753,2021-03-31,Facebook,FB,5197000000,11503000000,9497000000,4465000000,21040000000,11378000000,11378000000,,2006000000,26171000000,14793000000,5131000000,125000000,9497000000,9497000000
754,2020-12-31,Facebook,FB,5207000000,13055000000,11219000000,4880000000,22862000000,12775000000,12775000000,,1836000000,28072000000,15297000000,5210000000,280000000,11219000000,11219000000
755,2020-09-30,Facebook,FB,4763000000,8133000000,7846000000,4473000000,17276000000,8040000000,8040000000,,287000000,21470000000,13430000000,4194000000,93000000,7846000000,7846000000
756,2021-06-30,Fastenal,FAST,,315200000,239700000,382900000,700700000,317800000,317800000,-2600000,75500000,1507700000,1189900000,807000000,-2600000,239700000,239700000
757,2021-03-31,Fastenal,FAST,,277900000,210600000,363100000,643400000,280300000,280300000,-2400000,67300000,1417000000,1136700000,773600000,-2400000,210600000,210600000
758,2020-12-31,Fastenal,FAST,,262200000,196100000,354700000,618800000,264100000,264100000,-2500000,66100000,1358000000,1093900000,739200000,-1900000,196100000,196100000
759,2020-09-30,Fastenal,FAST,,287600000,221500000,351500000,640600000,289100000,289100000,-2600000,66100000,1413300000,1124200000,772700000,-1500000,221500000,221500000
760,2021-06-30,Federal Realty Investment Trust,FRT,,48059000,46204000,12846000,159507000,78986000,78986000,-31177000,0,231748000,152762000,72241000,-30927000,48059000,43895000
761,2021-03-31,Federal Realty Investment Trust,FRT,,49739000,48236000,10258000,138165000,64033000,64033000,-32085000,0,216823000,152790000,78658000,-14294000,49739000,45932000
762,2020-12-31,Federal Realty Investment Trust,FRT,,102211000,94725000,18739000,147122000,63959000,63959000,-37543000,0,218108000,154149000,70986000,38252000,102211000,92467000
763,2020-09-30,Federal Realty Investment Trust,FRT,,-33623000,-28289000,9308000,134224000,59285000,59285000,-36228000,0,206576000,147291000,72352000,-92908000,-33623000,-30548000
764,2021-05-31,FedEx,FDX,,2613000000,1868000000,428000000,7594000000,3333000000,3333000000,-186000000,745000000,22565000000,19232000000,14971000000,-720000000,1868000000,1868000000
765,2021-02-28,FedEx,FDX,,1049000000,892000000,428000000,5333000000,1217000000,1217000000,-187000000,157000000,21510000000,20293000000,16177000000,-168000000,892000000,889000000
766,2020-11-30,FedEx,FDX,,1406000000,1226000000,428000000,5417000000,1615000000,1615000000,-184000000,180000000,20563000000,18948000000,15146000000,-209000000,1226000000,1224000000
767,2020-08-31,FedEx,FDX,,1606000000,1245000000,428000000,5386000000,1791000000,1791000000,-184000000,361000000,19321000000,17530000000,13935000000,-185000000,1245000000,1243000000
768,2021-06-30,Fidelity National Information Services,FIS,,644000000,341000000,977000000,1340000000,363000000,363000000,-48000000,302000000,3475000000,3112000000,2135000000,281000000,342000000,341000000
769,2021-03-31,Fidelity National Information Services,FIS,,-467000000,-373000000,997000000,1105000000,108000000,108000000,-74000000,-97000000,3223000000,3115000000,2118000000,-575000000,-370000000,-373000000
770,2020-12-31,Fidelity National Information Services,FIS,,105000000,104000000,661000000,1206000000,545000000,545000000,-87000000,2000000,3316000000,2771000000,2110000000,-440000000,103000000,104000000
771,2020-09-30,Fidelity National Information Services,FIS,,143000000,20000000,667000000,1093000000,426000000,426000000,-84000000,121000000,3197000000,2771000000,2104000000,-283000000,22000000,20000000
772,2021-06-30,Fifth Third Bancorp,FITB,,911000000,709000000,861000000,2066000000,0,915000000,,202000000,2066000000,1151000000,0,-4000000,709000000,673000000
773,2021-03-31,Fifth Third Bancorp,FITB,,883000000,694000000,935000000,2125000000,0,910000000,,189000000,2125000000,1215000000,0,-27000000,694000000,672000000
774,2020-12-31,Fifth Third Bancorp,FITB,,746000000,604000000,926000000,1991000000,0,757000000,,142000000,1991000000,1234000000,0,-11000000,604000000,566000000
775,2020-09-30,Fifth Third Bancorp,FITB,,746000000,581000000,871000000,1918000000,0,758000000,,165000000,1918000000,1160000000,0,-12000000,581000000,560000000
776,2021-06-30,First Republic Bank,FRC,,451565000,373106000,676044000,1214330000,0,470188000,,78459000,1214330000,744142000,0,-18623000,373106000,349451000
777,2021-03-31,First Republic Bank,FRC,,428845000,334833000,638356000,1149241000,0,445470000,,94012000,1149241000,703771000,0,-16625000,334833000,316308000
778,2020-12-31,First Republic Bank,FRC,,379255000,295560000,583502000,1045299000,0,417705000,,83695000,1045299000,627594000,0,-38450000,295560000,279488000
779,2020-09-30,First Republic Bank,FRC,,364515000,293137000,532071000,972725000,0,375518000,,71378000,972725000,597207000,0,-11003000,293137000,278321000
780,2021-03-31,FirstEnergy,FE,,422000000,335000000,-117000000,1798000000,567000000,567000000,-279000000,87000000,2726000000,2159000000,928000000,-145000000,335000000,335000000
781,2020-12-31,FirstEnergy,FE,,216000000,242000000,-235000000,1843000000,689000000,689000000,-266000000,4000000,2354000000,1665000000,511000000,-473000000,212000000,242000000
782,2020-09-30,FirstEnergy,FE,,576000000,454000000,-235000000,2246000000,721000000,721000000,-258000000,116000000,3022000000,2301000000,776000000,-145000000,460000000,454000000
783,2020-06-30,FirstEnergy,FE,,373000000,309000000,-235000000,1819000000,515000000,515000000,-257000000,66000000,2522000000,2007000000,703000000,-142000000,307000000,309000000
784,2021-06-30,Fiserv,FISV,,512000000,269000000,1440000000,2084000000,644000000,644000000,-176000000,228000000,4051000000,3407000000,1967000000,-132000000,284000000,269000000
785,2021-03-31,Fiserv,FISV,,336000000,304000000,1367000000,1848000000,481000000,481000000,-177000000,18000000,3755000000,3274000000,1907000000,-145000000,318000000,304000000
786,2020-12-31,Fiserv,FISV,,333000000,300000000,1379000000,1978000000,599000000,599000000,-175000000,20000000,3832000000,3233000000,1854000000,-266000000,313000000,300000000
787,2020-09-30,Fiserv,FISV,,400000000,264000000,1408000000,1953000000,545000000,545000000,-176000000,124000000,3786000000,3241000000,1833000000,-145000000,276000000,264000000
788,2021-06-30,Fleetcor,FLT,,262519000,196247000,178233000,545087000,297612000,297612000,-34685000,66272000,667381000,369769000,122294000,-35093000,196247000,196247000
789,2021-03-31,Fleetcor,FLT,,235680000,184239000,160444000,492195000,265965000,265965000,-28551000,51441000,608623000,342658000,116428000,-30285000,184239000,184239000
790,2020-12-31,Fleetcor,FLT,,263188000,209851000,138698000,495819000,294233000,294233000,-30329000,53337000,617333000,323100000,121514000,-31045000,209851000,209851000
791,2020-09-30,Fleetcor,FLT,,235410000,188817000,137630000,465427000,264532000,264532000,-31383000,46593000,585283000,320751000,119856000,-29122000,188817000,188817000
792,2021-06-30,FMC Corporation,FMC,65900000,251200000,202900000,161000000,531800000,299100000,299100000,-32600000,33400000,1242000000,942900000,710200000,-47900000,217800000,202400000
793,2021-03-31,FMC Corporation,FMC,74000000,223500000,182600000,174100000,512400000,264300000,264300000,-32400000,32200000,1195600000,931300000,683200000,-40800000,191300000,182200000
794,2020-12-31,FMC Corporation,FMC,84600000,107500000,49500000,168700000,501400000,248600000,248600000,-34300000,68600000,1152200000,903600000,650800000,-141100000,38900000,49400000
795,2020-09-30,FMC Corporation,FMC,71700000,148900000,111400000,173300000,466400000,221300000,221300000,-35500000,18400000,1084600000,863300000,618200000,-72400000,130500000,111100000
796,2021-06-30,Ford,F,,735000000,561000000,1856000000,2864000000,1008000000,1008000000,-453000000,182000000,26752000000,25744000000,23888000000,-273000000,553000000,561000000
797,2021-03-31,Ford,F,,3942000000,3262000000,2231000000,5357000000,3126000000,3126000000,-476000000,680000000,36228000000,33102000000,30871000000,816000000,3262000000,3262000000
798,2020-12-31,Ford,F,,-3810000000,-2788000000,3304000000,1035000000,-2269000000,-2269000000,-472000000,-1019000000,35952000000,38221000000,34917000000,-1541000000,-2791000000,-2788000000
799,2020-09-30,Ford,F,,2756000000,2385000000,1822000000,4830000000,3008000000,3008000000,-507000000,366000000,37501000000,34493000000,32671000000,-252000000,2390000000,2385000000
800,2021-06-30,Fortinet,FTNT,106600000,145000000,137500000,361300000,614200000,146300000,146300000,-4500000,7500000,801100000,654800000,186900000,-1300000,137500000,137500000
801,2021-03-31,Fortinet,FTNT,97200000,119400000,107200000,336000000,553700000,120500000,120500000,-200000,12200000,710300000,589800000,156600000,-1100000,107200000,107200000
802,2020-12-31,Fortinet,FTNT,89000000,171700000,146700000,323800000,581000000,168200000,168200000,-200000,25000000,748000000,579800000,167000000,3500000,146700000,146700000
803,2020-09-30,Fortinet,FTNT,90000000,128400000,123400000,296100000,511900000,125800000,125800000,-200000,5000000,651100000,525300000,139200000,2600000,123400000,123400000
804,2021-07-02,Fortive,FTV,87800000,207500000,180900000,457100000,755500000,210600000,210600000,-25200000,25500000,1319700000,1109100000,564200000,-3100000,182000000,163700000
805,2021-04-02,Fortive,FTV,86200000,118700000,110200000,428900000,711900000,196800000,196800000,-27700000,7000000,1259200000,1062400000,547300000,-78100000,111700000,92900000
806,2020-12-31,Fortive,FTV,-10300000,1018000000,1215600000,23600000,-56800000,-70100000,-70100000,-17800000,-35800000,-552600000,-482500000,-495800000,1088100000,1053800000,1198400000
807,2020-09-25,Fortive,FTV,110700000,265100000,225800000,563100000,983400000,309600000,309600000,-43900000,39300000,1902300000,1592700000,918900000,-44500000,225800000,208500000
808,2021-06-30,Fortune Brands Home & Security,FBHS,,275000000,217200000,394600000,705800000,295200000,295200000,-21200000,57800000,1936100000,1640900000,1230300000,-20200000,217200000,217200000
809,2021-03-31,Fortune Brands Home & Security,FBHS,,223700000,177800000,371500000,647400000,259300000,259300000,-21400000,45900000,1771000000,1511700000,1123600000,-35600000,177800000,177800000
810,2020-12-31,Fortune Brands Home & Security,FBHS,,210700000,163600000,363200000,618100000,244000000,244000000,-19500000,47100000,1659700000,1415700000,1041600000,-33300000,163600000,163600000
811,2020-09-30,Fortune Brands Home & Security,FBHS,,219800000,164600000,327800000,580600000,242300000,242300000,-20100000,54000000,1652100000,1409800000,1071500000,-22500000,165800000,164600000
812,2021-06-30,Fox Corporation (Class A),FOXA,,357000000,253000000,540000000,1252000000,628000000,628000000,-99000000,85000000,2890000000,2262000000,1638000000,-271000000,272000000,253000000
813,2021-03-31,Fox Corporation (Class A),FOXA,,778000000,567000000,437000000,1330000000,815000000,815000000,-98000000,196000000,3215000000,2400000000,1885000000,-37000000,582000000,567000000
814,2020-12-31,Fox Corporation (Class A),FOXA,,304000000,224000000,442000000,741000000,229000000,229000000,-99000000,74000000,4087000000,3858000000,3346000000,75000000,230000000,224000000
815,2020-09-30,Fox Corporation (Class A),FOXA,,1479000000,1106000000,388000000,1549000000,1093000000,1093000000,-99000000,362000000,2717000000,1624000000,1168000000,386000000,1117000000,1106000000
816,2021-06-30,Fox Corporation (Class B),FOX,,357000000,253000000,540000000,1252000000,628000000,628000000,-99000000,85000000,2890000000,2262000000,1638000000,-271000000,272000000,253000000
817,2021-03-31,Fox Corporation (Class B),FOX,,778000000,567000000,437000000,1330000000,815000000,815000000,-98000000,196000000,3215000000,2400000000,1885000000,-37000000,582000000,567000000
818,2020-12-31,Fox Corporation (Class B),FOX,,304000000,224000000,442000000,741000000,229000000,229000000,-99000000,74000000,4087000000,3858000000,3346000000,75000000,230000000,224000000
819,2020-09-30,Fox Corporation (Class B),FOX,,1479000000,1106000000,388000000,1549000000,1093000000,1093000000,-99000000,362000000,2717000000,1624000000,1168000000,386000000,1117000000,1106000000
820,2021-06-30,Franklin Resources,BEN,,555400000,438400000,334400000,913500000,521100000,521100000,-25700000,83800000,2172900000,1651800000,1259400000,34300000,471600000,419000000
821,2021-03-31,Franklin Resources,BEN,,613500000,381800000,288200000,859500000,513400000,513400000,-15900000,128100000,2076500000,1563100000,1217000000,100100000,485400000,364900000
822,2020-12-31,Franklin Resources,BEN,,537300000,345300000,284900000,830000000,486900000,486900000,-29700000,142500000,1995100000,1508200000,1165100000,50400000,394800000,330700000
823,2020-09-30,Franklin Resources,BEN,,199600000,78900000,231900000,679000000,409800000,409800000,-15700000,73100000,1627400000,1217600000,948400000,-210200000,126500000,63600000
824,2021-06-30,Freeport-McMoRan,FCX,,1934000000,1083000000,87000000,2750000000,2133000000,2133000000,-148000000,603000000,5748000000,3615000000,2998000000,-199000000,1331000000,1079000000
825,2021-03-31,Freeport-McMoRan,FCX,,1396000000,718000000,100000000,2063000000,1532000000,1532000000,-145000000,443000000,4850000000,3318000000,2787000000,-136000000,953000000,718000000
826,2020-12-31,Freeport-McMoRan,FCX,,1469000000,708000000,117000000,1864000000,1335000000,1335000000,-201000000,611000000,4495000000,3160000000,2631000000,134000000,858000000,708000000
827,2020-09-30,Freeport-McMoRan,FCX,,729000000,329000000,72000000,1407000000,916000000,916000000,-120000000,297000000,3851000000,2935000000,2444000000,-187000000,432000000,326000000
828,2021-07-31,Gap,GPS,,359000000,258000000,1398000000,1823000000,425000000,425000000,-51000000,101000000,4211000000,3786000000,2388000000,-66000000,258000000,258000000
829,2021-05-01,Gap,GPS,,187000000,166000000,1329000000,1630000000,301000000,301000000,-54000000,21000000,3991000000,3690000000,2361000000,-114000000,166000000,166000000
830,2021-01-30,Gap,GPS,46000000,77000000,234000000,2913000000,3043000000,84000000,84000000,-60000000,-157000000,4424000000,4340000000,1381000000,-7000000,234000000,234000000
831,2020-10-31,Gap,GPS,46000000,121000000,95000000,1449000000,1620000000,171000000,171000000,-55000000,26000000,3994000000,3823000000,2374000000,-50000000,95000000,95000000
832,2021-06-26,Garmin,GRMN,200981000,372059000,316997000,208698000,780851000,371172000,371172000,,55062000,1326905000,955733000,546054000,887000,316997000,316997000
833,2021-03-27,Garmin,GRMN,203214000,250514000,220029000,188683000,641556000,249659000,249659000,,30485000,1072327000,822668000,430771000,855000,220029000,220029000
834,2020-12-26,Garmin,GRMN,199672000,391466000,333548000,220045000,790984000,371267000,371267000,,57918000,1351405000,980138000,560421000,20199000,333548000,333548000
835,2020-09-26,Garmin,GRMN,174882000,336717000,313417000,176000000,667983000,317101000,317101000,,23300000,1109194000,792093000,441211000,19616000,313417000,313417000
836,2021-06-30,Gartner,IT,,379187000,271236000,488496000,816517000,276016000,276016000,-31390000,107951000,1167319000,891303000,350802000,103171000,271236000,271236000
837,2021-03-31,Gartner,IT,,214753000,164100000,480755000,769571000,232552000,232552000,-10349000,50653000,1104038000,871486000,334467000,-17799000,164100000,164100000
838,2020-12-31,Gartner,IT,,156155000,119607000,523375000,761331000,181575000,181575000,-18154000,36548000,1112759000,931184000,351428000,-25420000,119607000,119607000
839,2020-09-30,Gartner,IT,,14167000,16964000,522708000,664851000,88172000,88172000,-30538000,-2797000,994618000,906446000,329767000,-74005000,16964000,16964000
840,2021-03-31,Generac Holdings,GNRC,22388000,185313000,148993000,101323000,321814000,189124000,189124000,-7723000,35368000,807434000,618310000,485620000,-3811000,149945000,149116000
841,2020-12-31,Generac Holdings,GNRC,21489000,163986000,125001000,98719000,299902000,170754000,170754000,-7910000,39006000,761082000,590328000,461180000,-6768000,124980000,126035000
842,2020-09-30,Generac Holdings,GNRC,20658000,147285000,114970000,91962000,276149000,155637000,155637000,-8096000,32050000,701355000,545718000,425206000,-8352000,115235000,115781000
843,2020-06-30,Generac Holdings,GNRC,19455000,82065000,66145000,92308000,215301000,95871000,95871000,-7932000,18473000,546848000,450977000,331547000,-13806000,63592000,64575000
844,2021-07-04,General Dynamics,GD,,881000000,737000000,475000000,1515000000,1040000000,1040000000,-109000000,144000000,9220000000,8180000000,7705000000,-159000000,737000000,737000000
845,2021-04-04,General Dynamics,GD,,845000000,708000000,502000000,1497000000,995000000,995000000,-123000000,137000000,9389000000,8394000000,7892000000,-150000000,708000000,708000000
846,2020-12-31,General Dynamics,GD,,1185000000,1002000000,614000000,1850000000,1236000000,1236000000,-132000000,183000000,10481000000,9245000000,8631000000,-51000000,1002000000,1002000000
847,2020-09-27,General Dynamics,GD,,978000000,834000000,480000000,1595000000,1115000000,1115000000,-118000000,144000000,9431000000,8316000000,7836000000,-137000000,834000000,834000000
848,2021-06-30,General Electric,GE,604000000,-1036000000,-1131000000,2648000000,3239000000,-13000000,-13000000,-261000000,-466000000,18279000000,18292000000,15040000000,-1023000000,-570000000,-1190000000
849,2021-03-31,General Electric,GE,561000000,236000000,-2803000000,2659000000,3722000000,502000000,502000000,-267000000,141000000,17118000000,16616000000,13396000000,-266000000,95000000,-2873000000
850,2020-12-31,General Electric,GE,2565000000,2721000000,2636000000,2571000000,6370000000,1234000000,1234000000,-254000000,163000000,21929000000,20695000000,15559000000,1487000000,2558000000,2419000000
851,2020-09-30,General Electric,GE,2565000000,-1661000000,-1144000000,2918000000,2963000000,45000000,45000000,-313000000,-501000000,19417000000,19372000000,16454000000,-1706000000,-1160000000,-1196000000
852,2021-05-30,General Mills,GIS,,506800000,416800000,789700000,1583500000,793800000,793800000,-110000000,106900000,4523600000,3729800000,2940100000,-287000000,399900000,416800000
853,2021-02-28,General Mills,GIS,,765800000,595700000,682900000,1554600000,871700000,871700000,-106000000,162000000,4520000000,3648300000,2965400000,-105900000,603800000,595700000
854,2020-11-29,General Mills,GIS,,885300000,688400000,771200000,1721600000,950400000,950400000,-100600000,189400000,4719400000,3769000000,2997800000,-65100000,695900000,688400000
855,2020-08-30,General Mills,GIS,,817200000,638900000,702900000,1590900000,888000000,888000000,-111100000,170800000,4364000000,3476000000,2773100000,-70800000,646400000,638900000
856,2021-06-30,General Motors,GM,,3750000000,2836000000,1533000000,5057000000,3524000000,3524000000,-243000000,971000000,34167000000,30643000000,29110000000,226000000,2779000000,2790000000
857,2021-03-31,General Motors,GM,,4191000000,3022000000,1320000000,5134000000,3814000000,3814000000,-250000000,1177000000,32474000000,28660000000,27340000000,377000000,3014000000,2976000000
858,2020-12-31,General Motors,GM,,3439000000,2846000000,2088000000,5014000000,2926000000,2926000000,-275000000,642000000,37518000000,34592000000,32504000000,513000000,2797000000,2801000000
859,2020-09-30,General Motors,GM,,4905000000,4045000000,1230000000,6098000000,4868000000,4868000000,-327000000,887000000,35480000000,30612000000,29382000000,37000000,4018000000,4005000000
860,2021-06-30,Genuine Parts,GPC,,269607000,196496000,1263673000,1689105000,346435000,346435000,-16107000,73111000,4783738000,4437303000,3094633000,-76828000,196496000,196496000
861,2021-03-31,Genuine Parts,GPC,,285859000,217710000,1186966000,1540815000,276644000,276644000,-19062000,68149000,4464714000,4188070000,2923899000,9215000,217710000,217710000
862,2020-12-31,Genuine Parts,GPC,,225546000,171204000,1121115000,1448110000,257112000,257112000,-21495000,53914000,4251594000,3994482000,2803484000,-31566000,171632000,171204000
863,2020-09-30,Genuine Parts,GPC,,297665000,227531000,1133851000,1528066000,319485000,319485000,-25788000,64747000,4370086000,4050601000,2842020000,-21820000,232918000,227531000
864,2021-06-30,Gilead Sciences,GILD,1134000000,1817000000,1522000000,1351000000,4827000000,2342000000,2342000000,-256000000,300000000,6217000000,3875000000,1390000000,-525000000,1517000000,1522000000
865,2021-03-31,Gilead Sciences,GILD,1055000000,2264000000,1729000000,1044000000,5062000000,2963000000,2963000000,-257000000,542000000,6423000000,3460000000,1361000000,-699000000,1722000000,1729000000
866,2020-12-31,Gilead Sciences,GILD,1412000000,1814000000,1551000000,1576000000,6904000000,3916000000,3916000000,-267000000,270000000,7421000000,3505000000,517000000,-2102000000,1544000000,1551000000
867,2020-09-30,Gilead Sciences,GILD,1158000000,825000000,360000000,1106000000,5436000000,3172000000,3172000000,-236000000,472000000,6577000000,3405000000,1141000000,-2347000000,353000000,360000000
868,2021-06-30,Global Payments,GPN,,327621000,263590000,760269000,1201127000,440858000,440858000,-79000000,60808000,2137437000,1696579000,936310000,-113237000,266813000,263590000
869,2021-03-31,Global Payments,GPN,,219085000,196681000,697702000,1064761000,367059000,367059000,-81200000,20675000,1990007000,1622948000,925246000,-147974000,198410000,196681000
870,2020-12-31,Global Payments,GPN,,202798000,182644000,738516000,1046598000,308082000,308082000,-82500000,17980000,1930193000,1622111000,883595000,-105284000,184818000,182644000
871,2020-09-30,Global Payments,GPN,,273064000,220971000,660775000,1016894000,356119000,356119000,-82100000,42834000,1917815000,1561696000,900921000,-83055000,230230000,220971000
872,2021-06-30,Globe Life,GL,,245243000,199618000,,346167000,267012000,267012000,-21769000,45625000,1271111000,1004099000,924944000,-21769000,199618000,199618000
873,2021-03-31,Globe Life,GL,,218794000,178517000,,321182000,244800000,244800000,-21178000,40277000,1266560000,1021760000,945378000,-26006000,178517000,178517000
874,2020-12-31,Globe Life,GL,,249984000,204240000,9800000,345738000,271393000,271393000,-21409000,45744000,1228941000,957548000,883203000,-21409000,204240000,204240000
875,2020-09-30,Globe Life,GL,,231538000,188945000,9800000,328609000,253212000,253212000,-21674000,42593000,1195042000,941830000,866433000,-21674000,188945000,188945000
876,2021-06-30,Goldman Sachs,GS,,6840000000,5486000000,5963000000,13984000000,0,7066000000,,1354000000,15480000000,8414000000,1496000000,-226000000,5486000000,5340000000
877,2021-03-31,Goldman Sachs,GS,,8337000000,6836000000,6730000000,16143000000,0,8411000000,,1501000000,17774000000,9363000000,1631000000,-74000000,6836000000,6704000000
878,2020-12-31,Goldman Sachs,GS,,5541000000,4506000000,3172000000,9797000000,0,5561000000,,1035000000,11448000000,5887000000,1651000000,-20000000,4506000000,4358000000
879,2020-09-30,Goldman Sachs,GS,,4299000000,3367000000,3720000000,9252000000,0,4555000000,,932000000,10503000000,5948000000,1251000000,-256000000,3367000000,3229000000
880,2021-06-30,Halliburton,HAL,,295000000,227000000,51000000,485000000,434000000,434000000,-134000000,65000000,3707000000,3273000000,3222000000,-139000000,230000000,227000000
881,2021-03-31,Halliburton,HAL,,223000000,170000000,48000000,418000000,370000000,370000000,-135000000,52000000,3451000000,3081000000,3033000000,-147000000,171000000,170000000
882,2020-12-31,Halliburton,HAL,,-240000000,-235000000,44000000,394000000,262000000,262000000,-135000000,-13000000,3237000000,2975000000,2843000000,-502000000,-227000000,-235000000
883,2020-09-30,Halliburton,HAL,,-1000000,-17000000,41000000,305000000,256000000,256000000,-133000000,18000000,2975000000,2719000000,2670000000,-257000000,-19000000,-17000000
884,2021-07-03,Hanesbrands,HBI,,173099000,128676000,457600000,683529000,225929000,225929000,-42440000,25236000,1751311000,1525382000,1067782000,-52830000,147863000,128676000
885,2021-04-03,Hanesbrands,HBI,,143101000,-263262000,405334000,605488000,200154000,200154000,-44460000,14697000,1508029000,1307875000,902541000,-57053000,128404000,-263262000
886,2021-01-02,Hanesbrands,HBI,44710000,-494134000,-332164000,449694000,735275000,206950000,206950000,-44115000,-161970000,1800843000,1593893000,1065568000,-701084000,-332164000,-332164000
887,2020-09-26,Hanesbrands,HBI,44710000,125394000,103278000,446355000,664349000,217994000,217994000,-43868000,22116000,1808266000,1590272000,1143917000,-92600000,103278000,103278000
888,2021-06-27,Hasbro,HAS,87200000,41100000,-22900000,459700000,755000000,178400000,178400000,-46100000,63000000,1322200000,1143800000,567200000,-137300000,-21900000,-22900000
889,2021-03-28,Hasbro,HAS,61800000,129500000,116200000,376500000,618500000,147300000,147300000,-47900000,12000000,1114800000,967500000,496300000,-17800000,117500000,116200000
890,2020-12-27,Hasbro,HAS,84659000,138474000,105173000,472029000,828432000,234683000,234683000,-48428000,32308000,1722971000,1488288000,894539000,-96209000,106166000,105173000
891,2020-09-27,Hasbro,HAS,62709000,299198000,220898000,462768000,904156000,342507000,342507000,-49400000,79215000,1776623000,1434116000,872467000,-43309000,219983000,220898000
892,2021-06-30,HCA Healthcare,HCA,,2117000000,1450000000,,5670000000,2485000000,2485000000,-386000000,453000000,14435000000,11950000000,8765000000,-368000000,1664000000,1450000000
893,2021-03-31,HCA Healthcare,HCA,,1973000000,1423000000,,5452000000,2334000000,2334000000,-384000000,393000000,13977000000,11643000000,8525000000,-361000000,1580000000,1423000000
894,2020-12-31,HCA Healthcare,HCA,,2072000000,1426000000,923000000,5534000000,2390000000,2390000000,-383000000,378000000,14293000000,11903000000,8759000000,-318000000,1694000000,1426000000
895,2020-09-30,HCA Healthcare,HCA,,988000000,668000000,923000000,5086000000,2141000000,2141000000,-385000000,209000000,13311000000,11170000000,8225000000,-1153000000,779000000,668000000
896,2021-06-30,Healthpeak Properties,PEAK,,167302000,276280000,24088000,284487000,88940000,88940000,-38681000,-763000,476238000,387298000,191751000,78362000,168065000,275993000
897,2021-03-31,Healthpeak Properties,PEAK,,-120577000,145788000,22439000,268863000,88886000,88886000,-46843000,8000,455276000,366390000,186413000,-209463000,-120585000,143337000
898,2020-12-31,Healthpeak Properties,PEAK,,-21835000,146394000,25507000,246060000,73378000,73378000,-54088000,-2631000,431697000,358319000,185637000,-95213000,-19204000,146129000
899,2020-09-30,Healthpeak Properties,PEAK,,-35407000,-63417000,21661000,277861000,82570000,82570000,-56235000,24174000,597739000,515169000,319878000,-117977000,-59581000,-63768000
900,2021-03-27,Henry Schein,HSIC,,231613000,165997000,657992000,890851000,232859000,232859000,-6485000,56685000,2924961000,2692102000,2034110000,-1246000,174928000,165997000
901,2020-12-26,Henry Schein,HSIC,,176038000,142633000,695331000,859711000,164380000,164380000,-11968000,29409000,3165725000,3001345000,2306014000,11658000,146629000,142633000
902,2020-09-26,Henry Schein,HSIC,,180818000,141697000,559636000,754299000,194663000,194663000,-11111000,29005000,2840146000,2645483000,2085847000,-13845000,151813000,141697000
903,2020-06-27,Henry Schein,HSIC,,-14802000,-10797000,445793000,454294000,8501000,8501000,-10486000,-950000,1684399000,1675898000,1230105000,-23303000,-13852000,-10797000
904,2021-06-30,Hess Corporation,HES,,135000000,-73000000,399000000,1213000000,254000000,254000000,-118000000,122000000,1535000000,1281000000,322000000,-119000000,13000000,-73000000
905,2021-03-31,Hess Corporation,HES,,459000000,252000000,359000000,1343000000,577000000,577000000,-117000000,123000000,1861000000,1284000000,518000000,-118000000,336000000,252000000
906,2020-12-31,Hess Corporation,HES,,45000000,-97000000,328000000,1061000000,138000000,138000000,-118000000,72000000,1289000000,1151000000,228000000,-93000000,-27000000,-97000000
907,2020-09-30,Hess Corporation,HES,,-178000000,-243000000,366000000,904000000,-32000000,-32000000,-118000000,5000000,1125000000,1157000000,221000000,-146000000,-183000000,-243000000
908,2021-07-31,Hewlett Packard Enterprise,HPE,506000000,406000000,392000000,1271000000,2382000000,599000000,599000000,-66000000,14000000,6897000000,6298000000,4515000000,-193000000,392000000,392000000
909,2021-04-30,Hewlett Packard Enterprise,HPE,503000000,288000000,259000000,1180000000,2287000000,513000000,513000000,-101000000,29000000,6700000000,6187000000,4413000000,-225000000,259000000,259000000
910,2021-01-31,Hewlett Packard Enterprise,HPE,468000000,205000000,223000000,1142000000,2288000000,552000000,552000000,-101000000,-18000000,6833000000,6281000000,4545000000,-347000000,223000000,223000000
911,2020-10-31,Hewlett Packard Enterprise,HPE,484000000,125000000,157000000,1126000000,2206000000,502000000,502000000,-178000000,-32000000,7208000000,6706000000,5002000000,-377000000,157000000,157000000
912,2021-03-31,Hilton Worldwide,HLT,,-144000000,-108000000,98000000,243000000,20000000,20000000,-103000000,-35000000,353000000,333000000,110000000,-164000000,-109000000,-108000000
913,2020-12-31,Hilton Worldwide,HLT,,-349000000,-224000000,127000000,242000000,102000000,102000000,-113000000,-124000000,384000000,282000000,142000000,-451000000,-225000000,-224000000
914,2020-09-30,Hilton Worldwide,HLT,,-114000000,-79000000,69000000,241000000,17000000,17000000,-116000000,-33000000,385000000,368000000,144000000,-131000000,-81000000,-79000000
915,2020-06-30,Hilton Worldwide,HLT,,-444000000,-430000000,66000000,81000000,-252000000,-252000000,-106000000,-12000000,176000000,428000000,95000000,-192000000,-432000000,-430000000
916,2021-06-26,Hologic,HOLX,69000000,337500000,268400000,260000000,769700000,362200000,362200000,-21600000,69400000,1168300000,806100000,398600000,-24700000,268100000,268400000
917,2021-03-27,Hologic,HOLX,71500000,780500000,619900000,220400000,1152600000,786000000,786000000,-21300000,161100000,1537600000,751600000,385000000,-5500000,619400000,619900000
918,2020-12-26,Hologic,HOLX,59300000,832400000,654400000,219500000,1243000000,892500000,892500000,-28100000,179000000,1609800000,717300000,366800000,-60100000,653400000,654400000
919,2020-09-26,Hologic,HOLX,57000000,617100000,494900000,224200000,1002400000,650100000,650100000,-25000000,123500000,1346900000,696800000,344500000,-33000000,493600000,494900000
920,2021-08-01,Home Depot,HD,,6318000000,4807000000,6409000000,13665000000,6663000000,6663000000,-326000000,1511000000,41118000000,34455000000,27453000000,-345000000,4807000000,4807000000
921,2021-05-02,Home Depot,HD,,5448000000,4145000000,6296000000,12742000000,5859000000,5859000000,-339000000,1303000000,37500000000,31641000000,24758000000,-411000000,4145000000,4145000000
922,2021-01-31,Home Depot,HD,,3756000000,2857000000,5722000000,10831000000,4548000000,4548000000,-337000000,899000000,32261000000,27713000000,21430000000,-792000000,2857000000,2857000000
923,2020-11-01,Home Depot,HD,,4523000000,3432000000,5663000000,11456000000,5265000000,5265000000,-340000000,1091000000,33536000000,28271000000,22080000000,-742000000,3432000000,3432000000
924,2021-06-30,Honeywell,HON,,1881000000,1430000000,880000000,2805000000,1925000000,1925000000,-79000000,434000000,8808000000,6883000000,6003000000,-44000000,1447000000,1430000000
925,2021-03-31,Honeywell,HON,,1861000000,1427000000,909000000,2745000000,1836000000,1836000000,-90000000,413000000,8454000000,6618000000,5709000000,25000000,1448000000,1427000000
926,2020-12-31,Honeywell,HON,,1710000000,1359000000,1041000000,2924000000,1883000000,1883000000,-95000000,331000000,8900000000,7017000000,5976000000,-173000000,1379000000,1359000000
927,2020-09-30,Honeywell,HON,,1148000000,758000000,852000000,2414000000,1562000000,1562000000,-101000000,367000000,7797000000,6235000000,5383000000,-414000000,781000000,758000000
928,2021-07-25,Hormel,HRL,,204238000,176917000,198822000,438248000,239426000,239426000,-11703000,27164000,2863670000,2624244000,2425422000,-35188000,177074000,176917000
929,2021-04-25,Hormel,HRL,,292621000,227901000,199966000,482307000,282341000,282341000,-7788000,64699000,2606621000,2324280000,2124314000,10280000,227922000,227901000
930,2021-01-24,Hormel,HRL,,277082000,222283000,196380000,465170000,268790000,268790000,-8227000,54687000,2461147000,2192357000,1995977000,8292000,222395000,222283000
931,2020-10-25,Hormel,HRL,31900000,278732000,234356000,158897000,537765000,346968000,346968000,-8271000,44207000,2420105000,2073137000,1882340000,-68236000,234525000,234356000
932,2021-03-31,Host Hotels & Resorts,HST,,-199000000,-152000000,24000000,30000000,-159000000,-159000000,-42000000,-46000000,408000000,567000000,378000000,-40000000,-153000000,-152000000
933,2020-12-31,Host Hotels & Resorts,HST,,-130000000,-64000000,21000000,-66000000,-254000000,-254000000,-51000000,-64000000,263000000,517000000,329000000,124000000,-66000000,-64000000
934,2020-09-30,Host Hotels & Resorts,HST,,-389000000,-313000000,18000000,-96000000,-280000000,-280000000,-66000000,-73000000,193000000,473000000,289000000,-109000000,-316000000,-313000000
935,2020-06-30,Host Hotels & Resorts,HST,,-402000000,-352000000,25000000,-185000000,-378000000,-378000000,-40000000,-46000000,78000000,456000000,263000000,-24000000,-356000000,-352000000
936,2021-03-31,Howmet Aerospace,HWM,,,0,,0,0,,,0,0,0,0,0,,
937,2020-12-31,Howmet Aerospace,HWM,4000000,71000000,106000000,58000000,407000000,278000000,278000000,-156000000,-35000000,1238000000,960000000,831000000,-207000000,106000000,106000000
938,2020-09-30,Howmet Aerospace,HWM,5000000,-12000000,36000000,74000000,241000000,94000000,94000000,-77000000,-48000000,1134000000,1040000000,893000000,-106000000,36000000,35000000
939,2020-06-30,Howmet Aerospace,HWM,4000000,-86000000,-96000000,79000000,334000000,178000000,178000000,-144000000,-2000000,1253000000,1075000000,919000000,-264000000,-84000000,-96000000
940,2021-07-31,HP,HPQ,477000000,1326000000,1108000000,1408000000,3388000000,1461000000,1461000000,-55000000,218000000,15289000000,13828000000,11901000000,-135000000,1108000000,1108000000
941,2021-04-30,HP,HPQ,514000000,1336000000,1228000000,1441000000,3440000000,1453000000,1453000000,-64000000,108000000,15877000000,14424000000,12437000000,-117000000,1228000000,1228000000
942,2021-01-31,HP,HPQ,471000000,1296000000,1068000000,1336000000,3324000000,1488000000,1488000000,-63000000,228000000,15646000000,14158000000,12322000000,-192000000,1068000000,1068000000
943,2020-10-31,HP,HPQ,381000000,776000000,668000000,1263000000,2679000000,1006000000,1006000000,-145000000,108000000,15258000000,14252000000,12579000000,-230000000,668000000,668000000
944,2021-03-31,Humana,HUM,,1061000000,828000000,2007000000,3372000000,1223000000,1223000000,-68000000,233000000,20668000000,19445000000,17296000000,-162000000,828000000,828000000
945,2020-12-31,Humana,HUM,,-452000000,-274000000,3037000000,2849000000,-315000000,-315000000,-72000000,-178000000,19062000000,19377000000,16213000000,-137000000,-274000000,-274000000
946,2020-09-30,Humana,HUM,,1790000000,1340000000,2544000000,4464000000,1792000000,1792000000,-75000000,450000000,20075000000,18283000000,15611000000,-2000000,1340000000,1340000000
947,2020-06-30,Humana,HUM,,2611000000,1828000000,2354000000,4908000000,2435000000,2435000000,-76000000,783000000,19083000000,16648000000,14175000000,176000000,1828000000,1828000000
948,2021-06-30,Huntington Bancshares,HBAN,,-1000000,-15000000,732000000,1074000000,0,287000000,,14000000,1074000000,787000000,0,-288000000,-15000000,-58000000
949,2021-03-31,Huntington Bancshares,HBAN,,634000000,532000000,682000000,1420000000,0,673000000,,102000000,1420000000,747000000,0,-39000000,532000000,501000000
950,2020-12-31,Huntington Bancshares,HBAN,,375000000,316000000,659000000,1130000000,0,386000000,,59000000,1130000000,744000000,0,-11000000,316000000,281000000
951,2020-09-30,Huntington Bancshares,HBAN,,358000000,303000000,656000000,1069000000,0,374000000,,55000000,1069000000,695000000,0,-16000000,303000000,275000000
952,2021-06-30,Huntington Ingalls Industries,HII,,161000000,129000000,160000000,322000000,162000000,162000000,-18000000,32000000,2231000000,2069000000,1909000000,-1000000,129000000,129000000
953,2021-03-31,Huntington Ingalls Industries,HII,,173000000,148000000,160000000,342000000,182000000,182000000,-21000000,25000000,2278000000,2096000000,1936000000,-9000000,148000000,148000000
954,2020-12-31,Huntington Ingalls Industries,HII,,303000000,249000000,226000000,547000000,322000000,322000000,-46000000,54000000,2757000000,2435000000,2210000000,-19000000,249000000,249000000
955,2020-09-30,Huntington Ingalls Industries,HII,,226000000,222000000,191000000,436000000,245000000,245000000,-27000000,4000000,2314000000,2069000000,1878000000,-19000000,222000000,222000000
956,2021-06-30,IBM,IBM,1657000000,1552000000,1325000000,5433000000,9062000000,2103000000,2103000000,-281000000,227000000,18745000000,16642000000,9683000000,-551000000,1325000000,1325000000
957,2021-03-31,IBM,IBM,1630000000,905000000,955000000,5297000000,8207000000,1421000000,1421000000,-280000000,-51000000,17729000000,16308000000,9522000000,-516000000,956000000,955000000
958,2020-12-31,IBM,IBM,1611000000,1289000000,1356000000,5450000000,10523000000,3612000000,3612000000,-317000000,24000000,20368000000,16756000000,9845000000,-2323000000,1265000000,1356000000
959,2020-09-30,IBM,IBM,1515000000,1827000000,1698000000,4919000000,8431000000,2120000000,2120000000,-323000000,128000000,17561000000,15441000000,9130000000,-293000000,1699000000,1698000000
960,2021-06-30,IDEX Corporation,IEX,,129876000,102195000,144680000,306072000,161392000,161392000,-11205000,27697000,685947000,524555000,379875000,-31516000,102179000,102195000
961,2021-03-31,IDEX Corporation,IEX,,145619000,112708000,133796000,293287000,159491000,159491000,-10776000,32947000,652036000,492545000,358749000,-13872000,112672000,112708000
962,2020-12-31,IDEX Corporation,IEX,,129871000,101068000,123935000,269168000,145233000,145233000,-10788000,28803000,614822000,469589000,345654000,-15362000,101068000,101068000
963,2020-09-30,IDEX Corporation,IEX,,121275000,103848000,116858000,251500000,134642000,134642000,-10642000,17427000,581113000,446471000,329613000,-13367000,103848000,103848000
964,2021-06-30,Idexx Laboratories,IDXX,37697000,251731000,202582000,192358000,489308000,259253000,259253000,-7613000,49125000,826142000,566889000,336834000,-7522000,202606000,202582000
965,2021-03-31,Idexx Laboratories,IDXX,37579000,240090000,204257000,185581000,470782000,247622000,247622000,-7584000,35801000,777707000,530085000,306925000,-7532000,204289000,204257000
966,2020-12-31,Idexx Laboratories,IDXX,38777000,177436000,174790000,185630000,409502000,185095000,185095000,-7828000,2478000,720938000,535843000,311436000,-7659000,174958000,174790000
967,2020-09-30,Idexx Laboratories,IDXX,37517000,163954000,146219000,213233000,422606000,171856000,171856000,-8110000,17633000,721789000,549933000,299183000,-7902000,146321000,146219000
968,2021-05-31,IHS Markit,INFO,,216500000,159000000,283300000,755600000,316600000,316600000,-55400000,57600000,1181400000,864800000,425800000,-100100000,158900000,159000000
969,2021-02-28,IHS Markit,INFO,,179000000,149300000,302200000,704700000,247500000,247500000,-55500000,30300000,1119900000,872400000,415200000,-68500000,148700000,149300000
970,2020-11-30,IHS Markit,INFO,,115300000,151100000,296200000,706900000,260400000,260400000,-57700000,-35600000,1107200000,846800000,400300000,-145100000,150900000,151100000
971,2020-08-31,IHS Markit,INFO,,203600000,162900000,258700000,687600000,282000000,282000000,-57700000,39900000,1073200000,791200000,385600000,-78400000,163700000,162900000
972,2021-03-31,Illinois Tool Works,ITW,,865000000,671000000,560000000,1505000000,911000000,911000000,-52000000,194000000,3544000000,2633000000,2039000000,-46000000,671000000,671000000
973,2020-12-31,Illinois Tool Works,ITW,,824000000,642000000,553000000,1475000000,887000000,887000000,-52000000,182000000,3475000000,2588000000,2000000000,-63000000,642000000,642000000
974,2020-09-30,Illinois Tool Works,ITW,,739000000,582000000,557000000,1397000000,792000000,792000000,-52000000,157000000,3307000000,2515000000,1910000000,-53000000,582000000,582000000
975,2020-06-30,Illinois Tool Works,ITW,,406000000,319000000,483000000,970000000,452000000,452000000,-51000000,87000000,2564000000,2112000000,1594000000,-46000000,319000000,319000000
976,2021-04-04,Illumina,ILMN,197000000,169000000,147000000,374000000,770000000,193000000,193000000,-19000000,22000000,1093000000,900000000,323000000,-24000000,147000000,147000000
977,2021-01-03,Illumina,ILMN,126000000,299000000,257000000,373000000,637000000,131000000,131000000,-16000000,42000000,953000000,822000000,316000000,168000000,257000000,257000000
978,2020-09-27,Illumina,ILMN,172000000,215000000,179000000,217000000,533000000,137000000,137000000,-11000000,36000000,794000000,657000000,261000000,78000000,179000000,179000000
979,2020-06-28,Illumina,ILMN,155000000,165000000,47000000,177000000,435000000,96000000,96000000,-11000000,118000000,633000000,537000000,198000000,69000000,47000000,47000000
980,2021-06-30,Incyte,INCY,,171633000,149456000,168859000,314327000,145468000,145468000,-358000,22177000,705709000,560241000,391382000,26165000,149456000,149456000
981,2021-03-31,Incyte,INCY,,69322000,53535000,154144000,258118000,103974000,103974000,-359000,15787000,604718000,500744000,346600000,-34652000,53535000,53535000
982,2020-12-31,Incyte,INCY,,168102000,149850000,167228000,334812000,167584000,167584000,-428000,18252000,789509000,621925000,454697000,518000,149850000,149850000
983,2020-09-30,Incyte,INCY,,-3508000,-15203000,121025000,133223000,12198000,12198000,-544000,11695000,620643000,608445000,487420000,-15706000,-15203000,-15203000
984,2021-06-30,Ingersoll Rand,IR,,150800000,233900000,266300000,512700000,166500000,166500000,-22700000,12500000,1279100000,1112600000,766400000,-15700000,138300000,233900000
985,2021-03-31,Ingersoll Rand,IR,,100700000,-90400000,251500000,452100000,114700000,114700000,-23100000,10600000,1129500000,1014800000,677400000,-14000000,90100000,-90400000
986,2020-12-31,Ingersoll Rand,IR,,108900000,151600000,245200000,526900000,167000000,167000000,-24400000,-42200000,1510700000,1343700000,983800000,-58100000,151100000,151600000
987,2020-09-30,Ingersoll Rand,IR,,48100000,29500000,244200000,482000000,123000000,123000000,-28800000,18200000,1335200000,1212200000,853200000,-74900000,29900000,29500000
988,2021-06-26,Intel,INTC,3715000000,5745000000,5061000000,1599000000,11206000000,5892000000,5892000000,-129000000,684000000,19631000000,13739000000,8425000000,-147000000,5061000000,5061000000
989,2021-03-27,Intel,INTC,3623000000,3906000000,3361000000,1328000000,10854000000,5903000000,5903000000,-190000000,545000000,19673000000,13770000000,8819000000,-1997000000,3361000000,3361000000
990,2020-12-26,Intel,INTC,3655000000,7488000000,5857000000,1757000000,11348000000,5936000000,5936000000,-148000000,1631000000,19978000000,14042000000,8630000000,1552000000,5857000000,5857000000
991,2020-09-26,Intel,INTC,3272000000,5041000000,4276000000,1435000000,9741000000,5034000000,5034000000,-160000000,765000000,18333000000,13299000000,8592000000,7000000,4276000000,4276000000
992,2021-06-30,Intercontinental Exchange,ICE,,1932000000,1252000000,647000000,1707000000,809000000,809000000,-106000000,679000000,1707000000,898000000,0,1123000000,1253000000,1252000000
993,2021-03-31,Intercontinental Exchange,ICE,,833000000,646000000,632000000,1797000000,910000000,910000000,-107000000,183000000,1797000000,887000000,0,-77000000,650000000,646000000
994,2020-12-31,Intercontinental Exchange,ICE,,674000000,526000000,625000000,1671000000,800000000,800000000,-112000000,146000000,1671000000,871000000,0,-126000000,528000000,526000000
995,2020-09-30,Intercontinental Exchange,ICE,,583000000,390000000,528000000,1411000000,703000000,703000000,-89000000,189000000,1411000000,708000000,0,-120000000,394000000,390000000
996,2021-06-30,International Flavors & Fragrances,IFF,164000000,44000000,28000000,385000000,1105000000,356000000,356000000,-77000000,14000000,3089000000,2733000000,1984000000,-312000000,30000000,29000000
997,2021-03-31,International Flavors & Fragrances,IFF,143000000,-54000000,-42000000,309000000,936000000,332000000,332000000,-65000000,-14000000,2465000000,2133000000,1529000000,-386000000,-40000000,-43000000
998,2020-12-31,International Flavors & Fragrances,IFF,100038000,79298000,67589000,214333000,513819000,149063000,149063000,-32756000,12734000,1270073000,1121010000,756254000,-69765000,66564000,63928000
999,2020-09-30,International Flavors & Fragrances,IFF,89968000,105500000,84828000,188130000,524530000,198694000,198694000,-34844000,19269000,1268076000,1069382000,743546000,-93194000,86231000,85592000
1000,2021-06-30,International Paper,IP,,536000000,432000000,828000000,1703000000,524000000,524000000,-117000000,102000000,5616000000,5092000000,3913000000,12000000,434000000,432000000
1001,2021-03-31,International Paper,IP,,448000000,349000000,714000000,1516000000,449000000,449000000,-124000000,99000000,5363000000,4914000000,3847000000,-1000000,349000000,349000000
1002,2020-12-31,International Paper,IP,,187000000,153000000,802000000,1580000000,404000000,404000000,-133000000,34000000,5239000000,4835000000,3659000000,-217000000,153000000,153000000
1003,2020-09-30,International Paper,IP,,254000000,204000000,726000000,1582000000,492000000,492000000,-148000000,50000000,5123000000,4631000000,3541000000,-238000000,204000000,204000000
1004,2021-06-30,Interpublic Group,IPG,,354500000,263300000,29400000,485000000,385500000,385500000,-42600000,86700000,2269600000,1884100000,1784600000,-31000000,267800000,263300000
1005,2021-03-31,Interpublic Group,IPG,,116200000,91700000,28200000,343100000,245700000,245700000,-49600000,23800000,2027700000,1782000000,1684600000,-129500000,92400000,91700000
1006,2020-12-31,Interpublic Group,IPG,,175100000,112300000,335700000,887700000,478300000,478300000,-46800000,58100000,2284400000,1806100000,1396700000,-303200000,117000000,112300000
1007,2020-09-30,Interpublic Group,IPG,,192200000,279700000,9900000,377600000,296700000,296700000,-50800000,-86300000,1954600000,1657900000,1577000000,-104500000,278500000,279700000
1008,2021-04-30,Intuit,INTU,464000000,1921000000,1464000000,1146000000,3592000000,1914000000,1914000000,-7000000,457000000,4173000000,2259000000,581000000,7000000,1464000000,1464000000
1009,2021-01-31,Intuit,INTU,368000000,22000000,20000000,804000000,1223000000,1000000,1000000,-7000000,2000000,1576000000,1575000000,353000000,21000000,20000000,20000000
1010,2020-10-31,Intuit,INTU,325000000,210000000,198000000,531000000,1074000000,209000000,209000000,-8000000,12000000,1323000000,1114000000,249000000,1000000,198000000,198000000
1011,2020-07-31,Intuit,INTU,393000000,486000000,445000000,617000000,1499000000,483000000,483000000,-7000000,41000000,1816000000,1333000000,317000000,3000000,445000000,445000000
1012,2021-03-31,Intuitive Surgical,ISRG,159800000,448800000,426300000,326000000,902600000,416800000,416800000,,13600000,1292100000,875300000,389500000,32000000,435200000,426300000
1013,2020-12-31,Intuitive Surgical,ISRG,149800000,436500000,365200000,331400000,895800000,414600000,414600000,,72900000,1329100000,914500000,433300000,21900000,363600000,365200000
1014,2020-09-30,Intuitive Surgical,ISRG,155000000,355200000,313900000,298900000,724300000,270400000,270400000,,38400000,1077700000,807300000,353400000,84800000,316800000,313900000
1015,2020-06-30,Intuitive Surgical,ISRG,143200000,107200000,68000000,279100000,502900000,80600000,80600000,,37000000,852100000,771500000,349200000,26600000,70200000,68000000
1016,2021-06-30,Invesco,IVZ,,649300000,427500000,127800000,563200000,419400000,419400000,-63000000,154200000,1721400000,1302000000,1158200000,229900000,495100000,368300000
1017,2021-03-31,Invesco,IVZ,,478100000,327000000,112400000,520600000,392300000,392300000,-64700000,106500000,1659700000,1267400000,1139100000,85800000,371600000,267800000
1018,2020-12-31,Invesco,IVZ,,399700000,270300000,116500000,507300000,390800000,390800000,-67700000,68900000,1630100000,1239300000,1122800000,8900000,330800000,211100000
1019,2020-09-30,Invesco,IVZ,,386600000,250900000,105300000,447300000,342000000,342000000,-75600000,91900000,1497600000,1155600000,1050300000,44600000,294700000,191700000
1020,2020-12-31,IPG Photonics,IPGP,31766000,65596000,49339000,44686000,146879000,70427000,70427000,,15920000,336630000,266203000,189751000,-4831000,49676000,49339000
1021,2020-09-30,IPG Photonics,IPGP,31710000,42522000,35604000,46370000,152792000,74712000,74712000,,6992000,318441000,243729000,165649000,-32190000,35530000,35604000
1022,2020-06-30,IPG Photonics,IPGP,31584000,49514000,38226000,43725000,136449000,61140000,61140000,,11148000,296411000,235271000,159962000,-11626000,38366000,38226000
1023,2020-03-31,IPG Photonics,IPGP,31838000,48060000,36403000,45807000,102876000,25231000,25231000,,11294000,249242000,224011000,146366000,22829000,36766000,36403000
1024,2021-06-30,IQVIA,IQV,,223000000,175000000,482000000,1115000000,290000000,290000000,-94000000,48000000,3438000000,3148000000,2323000000,-67000000,175000000,175000000
1025,2021-03-31,IQVIA,IQV,,261000000,212000000,442000000,1116000000,351000000,351000000,-99000000,44000000,3409000000,3058000000,2293000000,-90000000,217000000,212000000
1026,2020-12-31,IQVIA,IQV,,193000000,119000000,464000000,1126000000,318000000,318000000,-102000000,63000000,3298000000,2980000000,2172000000,-125000000,130000000,119000000
1027,2020-09-30,IQVIA,IQV,,105000000,101000000,460000000,986000000,207000000,207000000,-100000000,-3000000,2786000000,2579000000,1800000000,-102000000,108000000,101000000
1028,2021-03-31,Iron Mountain,IRM,,61271000,45603000,258723000,630131000,205766000,205766000,-106993000,14640000,1082040000,876274000,451909000,-144495000,46631000,45603000
1029,2020-12-31,Iron Mountain,IRM,,243060000,247410000,236440000,610430000,205607000,205607000,-106948000,-3695000,1059653000,854046000,449223000,37453000,246755000,247410000
1030,2020-09-30,Iron Mountain,IRM,,52496000,38394000,232095000,602142000,212795000,212795000,-106779000,13934000,1036647000,823852000,434505000,-160299000,38562000,38394000
1031,2020-06-30,Iron Mountain,IRM,,2570000,-7086000,240310000,583194000,179034000,179034000,-106023000,9683000,982239000,803205000,399045000,-176464000,-7113000,-7086000
1032,2021-06-30,J. B. Hunt,JBHT,,229487000,172162000,83013000,478139000,241546000,241546000,-12059000,57325000,2908370000,2666824000,2430231000,-12059000,172162000,172162000
1033,2021-03-31,J. B. Hunt,JBHT,,195628000,146606000,82921000,441932000,207652000,207652000,-12024000,49022000,2618149000,2410497000,2176217000,-12024000,146606000,146606000
1034,2020-12-31,J. B. Hunt,JBHT,,197347000,154007000,92439000,440276000,199492000,199492000,-10831000,43340000,2737652000,2538160000,2297376000,-2145000,154007000,154007000
1035,2020-09-30,J. B. Hunt,JBHT,,163608000,125496000,77306000,398897000,175503000,175503000,-11895000,38112000,2472523000,2297020000,2073626000,-11895000,125496000,125496000
1036,2021-06-30,Jack Henry & Associates,JKHY,28814000,95683000,76862000,50259000,175369000,96296000,96296000,-619000,18821000,450287000,353991000,274918000,-613000,76862000,76862000
1037,2021-03-31,Jack Henry & Associates,JKHY,27395000,90937000,71409000,47408000,166006000,91203000,91203000,-290000,19528000,433776000,342573000,267770000,-266000,71409000,71409000
1038,2020-12-31,Jack Henry & Associates,JKHY,26780000,93567000,71982000,44167000,164579000,93632000,93632000,-117000,21585000,422361000,328729000,257782000,-65000,71982000,71982000
1039,2020-09-30,Jack Henry & Associates,JKHY,26057000,117539000,91216000,45226000,188871000,117588000,117588000,-117000,26323000,451800000,334212000,262929000,-49000,91216000,91216000
1040,2021-07-02,Jacobs Engineering Group,J,,283394000,165794000,564711000,816935000,252224000,252224000,-20011000,109186000,3576436000,3324212000,2759501000,31170000,174208000,108487000
1041,2021-04-02,Jacobs Engineering Group,J,,-112281000,11045000,520750000,767013000,246263000,246263000,-15464000,-20772000,3547873000,3301610000,2780860000,-358544000,-91509000,11045000
1042,2021-01-01,Jacobs Engineering Group,J,,354111000,257048000,386419000,632060000,245641000,245641000,-17313000,87023000,3381836000,3136195000,2749776000,108470000,267088000,257048000
1043,2020-10-02,Jacobs Engineering Group,J,,60156000,81990000,343176000,667249000,324073000,324073000,-14043000,-19721000,3519689000,3195616000,2852440000,-263917000,79877000,82001000
1044,2021-07-31,JM Smucker,SJM,,205200000,153900000,329300000,644000000,260500000,260500000,-43100000,51300000,1858000000,1597500000,1214000000,-55300000,153900000,153900000
1045,2021-04-30,JM Smucker,SJM,,193300000,147000000,416700000,739100000,261200000,261200000,-42400000,46300000,1920200000,1659000000,1181100000,-67900000,147000000,147000000
1046,2021-01-31,JM Smucker,SJM,,361500000,261500000,374400000,809400000,378000000,378000000,-43500000,100000000,2076700000,1698700000,1267300000,-16500000,261500000,261500000
1047,2020-10-31,JM Smucker,SJM,,303500000,230800000,388000000,818200000,375600000,375600000,-45100000,72700000,2034000000,1658400000,1215800000,-72100000,230800000,230800000
1048,2021-07-04,Johnson & Johnson,JNJ,3394000000,6662000000,6278000000,5939000000,15745000000,6412000000,6412000000,-40000000,384000000,23312000000,16900000000,7567000000,250000000,6278000000,6278000000
1049,2021-04-04,Johnson & Johnson,JNJ,3178000000,7429000000,6197000000,5263000000,15285000000,6844000000,6844000000,-63000000,1232000000,22321000000,15477000000,7036000000,585000000,6197000000,6197000000
1050,2021-01-03,Johnson & Johnson,JNJ,4032000000,1647000000,1738000000,6714000000,14692000000,3946000000,3946000000,-87000000,-91000000,22475000000,18529000000,7783000000,-2299000000,1738000000,1738000000
1051,2020-09-27,Johnson & Johnson,JNJ,2840000000,4401000000,3554000000,5336000000,14142000000,5966000000,5966000000,-44000000,847000000,21082000000,15116000000,6940000000,-1565000000,3554000000,3554000000
1052,2021-06-30,Johnson Controls,JCI,,769000000,574000000,1152000000,2197000000,1045000000,1045000000,-55000000,108000000,6341000000,5296000000,4144000000,-276000000,661000000,574000000
1053,2021-03-31,Johnson Controls,JCI,,606000000,343000000,1274000000,1943000000,669000000,669000000,-53000000,209000000,5594000000,4925000000,3651000000,-63000000,397000000,343000000
1054,2020-12-31,Johnson Controls,JCI,,433000000,451000000,1298000000,1728000000,430000000,430000000,-59000000,61000000,5341000000,4911000000,3613000000,3000000,372000000,451000000
1055,2020-09-30,Johnson Controls,JCI,274000000,521000000,441000000,819000000,1975000000,882000000,882000000,-58000000,31000000,5954000000,5072000000,3979000000,-361000000,490000000,441000000
1056,2021-06-30,JPMorgan Chase,JPM,,15097000000,11948000000,16403000000,32764000000,0,15282000000,,3149000000,32764000000,17482000000,0,-185000000,11948000000,11496000000
1057,2021-03-31,JPMorgan Chase,JPM,,17697000000,14300000000,17189000000,36422000000,0,17725000000,,3397000000,36422000000,18697000000,0,-28000000,14300000000,13851000000
1058,2020-12-31,JPMorgan Chase,JPM,,15065000000,12136000000,14705000000,31113000000,0,15341000000,,2929000000,31113000000,15772000000,0,-276000000,12136000000,11698000000
1059,2020-09-30,JPMorgan Chase,JPM,,11661000000,9443000000,14984000000,28536000000,0,12185000000,,2218000000,28536000000,16351000000,0,-524000000,9443000000,9015000000
1060,2021-06-30,Juniper Networks,JNPR,245800000,74800000,62000000,328800000,681900000,107300000,107300000,-12600000,12800000,1172300000,1065000000,490400000,-32500000,62000000,62000000
1061,2021-03-31,Juniper Networks,JNPR,254700000,-37800000,-31100000,313800000,615600000,47100000,47100000,-13700000,-6700000,1074400000,1027300000,458800000,-84900000,-31100000,-31100000
1062,2020-12-31,Juniper Networks,JNPR,242500000,39200000,30800000,298700000,717000000,175800000,175800000,-18500000,8400000,1222600000,1046800000,505600000,-136600000,30800000,30800000
1063,2020-09-30,Juniper Networks,JNPR,242400000,111600000,145400000,289100000,657800000,126300000,126300000,-19100000,-33800000,1138200000,1011900000,480400000,-14700000,145400000,145400000
1064,2021-06-30,Kansas City Southern,KSU,,-459600000,-378500000,,380300000,289100000,289100000,-39100000,-81600000,749500000,460400000,369200000,-748700000,-378000000,-378600000
1065,2021-03-31,Kansas City Southern,KSU,,211900000,153000000,,368800000,272300000,272300000,-39000000,58500000,706000000,433700000,337200000,-60400000,153400000,153000000
1066,2020-12-31,Kansas City Southern,KSU,,235900000,165700000,,384300000,276900000,276900000,-39100000,69600000,693400000,416500000,309100000,-41000000,166300000,165700000
1067,2020-09-30,Kansas City Southern,KSU,,238700000,189800000,,363200000,274000000,274000000,-39500000,48500000,659600000,385600000,296400000,-35300000,190200000,189700000
1068,2021-04-03,Kellogg's,K,,480000000,368000000,607000000,1167000000,560000000,560000000,-59000000,109000000,3584000000,3024000000,2417000000,-80000000,371000000,368000000
1069,2021-01-02,Kellogg's,K,,263000000,205000000,749000000,1188000000,439000000,439000000,-85000000,55000000,3464000000,3025000000,2276000000,-176000000,208000000,205000000
1070,2020-09-26,Kellogg's,K,,417000000,348000000,790000000,1201000000,411000000,411000000,-63000000,65000000,3429000000,3018000000,2228000000,6000000,352000000,348000000
1071,2020-06-27,Kellogg's,K,,463000000,351000000,669000000,1207000000,538000000,538000000,-69000000,109000000,3465000000,2927000000,2258000000,-75000000,354000000,351000000
1072,2021-06-30,KeyCorp,KEY,,913000000,729000000,907000000,1989000000,0,927000000,,189000000,1989000000,1062000000,0,-14000000,724000000,703000000
1073,2021-03-31,KeyCorp,KEY,,765000000,622000000,908000000,1836000000,0,780000000,,147000000,1836000000,1056000000,0,-16000000,618000000,595000000
1074,2020-12-31,KeyCorp,KEY,,689000000,582000000,913000000,1817000000,0,743000000,,114000000,1817000000,1074000000,0,-54000000,575000000,556000000
1075,2020-09-30,KeyCorp,KEY,,484000000,428000000,852000000,1521000000,0,504000000,,60000000,1521000000,1017000000,0,-20000000,424000000,401000000
1076,2021-04-30,Keysight Technologies,KEYS,209000000,208000000,186000000,308000000,737000000,224000000,224000000,-19000000,22000000,1221000000,997000000,484000000,-16000000,186000000,186000000
1077,2021-01-31,Keysight Technologies,KEYS,199000000,195000000,172000000,294000000,707000000,219000000,219000000,-20000000,23000000,1180000000,961000000,473000000,-24000000,172000000,172000000
1078,2020-10-31,Keysight Technologies,KEYS,193000000,266000000,217000000,287000000,756000000,278000000,278000000,-19000000,49000000,1220000000,942000000,464000000,-12000000,217000000,217000000
1079,2020-07-31,Keysight Technologies,KEYS,169000000,185000000,176000000,241000000,606000000,200000000,200000000,-20000000,9000000,1011000000,811000000,405000000,-15000000,176000000,176000000
1080,2021-03-31,Kimberly-Clark,KMB,,741000000,584000000,806000000,1614000000,813000000,813000000,-63000000,147000000,4743000000,3930000000,3129000000,-72000000,594000000,584000000
1081,2020-12-31,Kimberly-Clark,KMB,,712000000,539000000,960000000,1710000000,815000000,815000000,-64000000,166000000,4836000000,4021000000,3126000000,-103000000,546000000,539000000
1082,2020-09-30,Kimberly-Clark,KMB,,597000000,472000000,885000000,1697000000,783000000,783000000,-62000000,114000000,4683000000,3900000000,2986000000,-186000000,483000000,472000000
1083,2020-06-30,Kimberly-Clark,KMB,,891000000,681000000,817000000,1837000000,1000000000,1000000000,-65000000,199000000,4612000000,3612000000,2775000000,-109000000,692000000,681000000
1084,2021-06-30,Kimco Realty,KIM,,118393000,116697000,24754000,199532000,102205000,102205000,-46812000,1275000,289016000,186811000,89484000,16188000,117118000,109671000
1085,2021-03-31,Kimco Realty,KIM,,142733000,137942000,24478000,193817000,94463000,94463000,-47716000,1308000,282308000,187845000,88491000,48270000,141425000,130796000
1086,2020-12-31,Kimco Realty,KIM,,202295000,201234000,12201000,177826000,91330000,91330000,-45887000,496000,269441000,178111000,91615000,110965000,201799000,195952000
1087,2020-09-30,Kimco Realty,KIM,,-37041000,-38394000,28795000,173778000,73279000,73279000,-46942000,388000,259792000,186513000,86014000,-110320000,-37429000,-44999000
1088,2021-03-31,Kinder Morgan,KMI,,1776000000,1409000000,156000000,2688000000,1882000000,1882000000,-377000000,351000000,5211000000,3329000000,2523000000,-106000000,1425000000,1402000000
1089,2020-12-31,Kinder Morgan,KMI,,800000000,607000000,187000000,1723000000,925000000,925000000,-381000000,177000000,3115000000,2190000000,1392000000,-125000000,623000000,603000000
1090,2020-09-30,Kinder Morgan,KMI,,612000000,455000000,153000000,1621000000,830000000,830000000,-383000000,140000000,2919000000,2089000000,1298000000,-218000000,472000000,452000000
1091,2020-06-30,Kinder Morgan,KMI,,-520000000,-637000000,155000000,1513000000,723000000,723000000,-395000000,104000000,2560000000,1837000000,1047000000,-1243000000,-624000000,-640000000
1092,2021-06-30,KLA Corporation,KLAC,241428000,708843000,632978000,193861000,1153230000,717941000,717941000,-39970000,75785000,1925471000,1207530000,772241000,-9098000,633058000,632978000
1093,2021-03-31,KLA Corporation,KLAC,238957000,640403000,567496000,183040000,1094144000,672147000,672147000,-39092000,73233000,1803773000,1131626000,709629000,-31744000,567170000,567496000
1094,2020-12-31,KLA Corporation,KLAC,229064000,527402000,457251000,181909000,981137000,570164000,570164000,-38880000,70419000,1650870000,1080706000,669733000,-42762000,456983000,457251000
1095,2020-09-30,KLA Corporation,KLAC,219038000,483806000,420567000,172631000,918058000,526389000,526389000,-39386000,63664000,1538620000,1012231000,620562000,-42583000,420142000,420567000
1096,2021-06-26,Kraft Heinz,KHC,,645000000,-27000000,866000000,2292000000,1426000000,1426000000,-613000000,670000000,6615000000,5189000000,4323000000,-781000000,-25000000,-27000000
1097,2021-03-27,Kraft Heinz,KHC,,704000000,563000000,815000000,2204000000,1389000000,1389000000,-415000000,136000000,6394000000,5005000000,4190000000,-685000000,568000000,563000000
1098,2020-12-26,Kraft Heinz,KHC,119000000,1286000000,1032000000,622000000,2521000000,1780000000,1780000000,-328000000,252000000,6939000000,5159000000,4418000000,-494000000,1034000000,1032000000
1099,2020-09-26,Kraft Heinz,KHC,119000000,906000000,597000000,839000000,2341000000,1502000000,1502000000,-314000000,308000000,6441000000,4939000000,4100000000,-596000000,598000000,597000000
1100,2021-05-14,Kroger,KR,,179000000,140000000,7580000000,9351000000,910000000,910000000,-165000000,36000000,41298000000,40388000000,31947000000,-731000000,143000000,139000000
1101,2021-01-30,Kroger,KR,,-110000000,-77000000,7256000000,7934000000,4000000,4000000,-106000000,-34000000,30737000000,30733000000,22803000000,-114000000,-76000000,-75000000
1102,2020-11-07,Kroger,KR,,834000000,631000000,5333000000,6822000000,858000000,858000000,-129000000,202000000,29723000000,28865000000,22901000000,-24000000,632000000,625000000
1103,2020-08-15,Kroger,KR,,1061000000,819000000,5439000000,6938000000,882000000,882000000,-135000000,241000000,30489000000,29607000000,23551000000,179000000,820000000,809000000
1104,2021-07-02,L3Harris Technologies,LHX,,582000000,413000000,757000000,1417000000,660000000,660000000,-65000000,169000000,4668000000,4008000000,3251000000,-78000000,413000000,413000000
1105,2021-04-02,L3Harris Technologies,LHX,,527000000,468000000,669000000,1354000000,685000000,685000000,-69000000,60000000,4567000000,3882000000,3213000000,-158000000,467000000,468000000
1106,2021-01-01,L3Harris Technologies,LHX,,247000000,193000000,713000000,1399000000,686000000,686000000,-68000000,63000000,4660000000,3974000000,3261000000,-439000000,184000000,193000000
1107,2020-10-02,L3Harris Technologies,LHX,,518000000,426000000,691000000,1311000000,620000000,620000000,-66000000,87000000,4463000000,3843000000,3152000000,-102000000,431000000,426000000
1108,2021-03-31,LabCorp,LH,,1021800000,769600000,418300000,1599000000,1117800000,1117800000,-48500000,251700000,4161500000,3043700000,2562500000,-96000000,770100000,769600000
1109,2020-12-31,LabCorp,LH,,1242700000,938300000,495500000,1961400000,1402600000,1402600000,-48300000,304100000,4489800000,3087200000,2528400000,-159900000,938600000,938300000
1110,2020-09-30,LabCorp,LH,,947100000,703400000,413200000,1559400000,1084000000,1084000000,-51400000,243400000,3896100000,2812100000,2336700000,-136900000,703700000,703400000
1111,2020-06-30,LabCorp,LH,,297000000,231600000,383700000,760500000,316700000,316700000,-52700000,65400000,2768800000,2452100000,2008300000,-19700000,231600000,231600000
1112,2021-06-27,Lam Research,LRCX,381749000,1308761000,1144657000,217525000,1915201000,1315927000,1315927000,-51695000,164104000,4145179000,2829252000,2229978000,-7166000,1144657000,1144657000
1113,2021-03-28,Lam Research,LRCX,381120000,1159988000,1071121000,203703000,1780131000,1195308000,1195308000,-52236000,88867000,3847654000,2652346000,2067523000,-35320000,1071121000,1071121000
1114,2020-12-27,Lam Research,LRCX,375172000,979783000,869229000,218899000,1603795000,1009724000,1009724000,-52551000,110554000,3456237000,2446513000,1852442000,-29941000,869229000,869229000
1115,2020-09-27,Lam Research,LRCX,355367000,922272000,823451000,189748000,1506179000,961064000,961064000,-52115000,98821000,3177080000,2216016000,1670901000,-38792000,823451000,823451000
1116,2021-05-30,Lamb Weston,LW,12900000,79800000,65500000,85500000,198000000,99600000,99600000,-28700000,14300000,1007500000,907900000,809500000,-19800000,65500000,65500000
1117,2021-02-28,Lamb Weston,LW,12900000,82400000,66100000,95100000,196700000,101600000,101600000,-29300000,16300000,895800000,794200000,699100000,-19200000,66100000,66100000
1118,2020-11-29,Lamb Weston,LW,12900000,128800000,96900000,78900000,223500000,144600000,144600000,-30000000,31900000,896100000,751500000,672600000,-15800000,96900000,96900000
1119,2020-08-30,Lamb Weston,LW,12900000,117300000,89300000,74100000,229800000,155700000,155700000,-30300000,28000000,871500000,715800000,641700000,-38400000,89300000,89300000
1120,2021-03-31,Las Vegas Sands,LVS,,-266000000,-278000000,297000000,468000000,-93000000,-93000000,-154000000,14000000,1196000000,1289000000,728000000,-173000000,-280000000,-278000000
1121,2020-12-31,Las Vegas Sands,LVS,,-368000000,-299000000,286000000,1258000000,-199000000,-199000000,-150000000,8000000,1146000000,1345000000,-112000000,-169000000,-376000000,-299000000
1122,2020-09-30,Las Vegas Sands,LVS,,-748000000,-565000000,313000000,83000000,-552000000,-552000000,-137000000,-17000000,586000000,1138000000,503000000,-196000000,-731000000,-565000000
1123,2020-06-30,Las Vegas Sands,LVS,,-1039000000,-820000000,337000000,-274000000,-917000000,-917000000,-118000000,-54000000,98000000,1015000000,372000000,-122000000,-985000000,-820000000
1124,2021-03-31,Leggett & Platt,LEG,,109300000,87500000,106000000,247500000,125700000,125700000,-19300000,21800000,1150900000,1025200000,903400000,-16400000,87500000,87500000
1125,2020-12-31,Leggett & Platt,LEG,,130900000,103200000,103200000,258100000,138600000,138600000,-19500000,27700000,1182000000,1043400000,923900000,-7700000,103200000,103200000
1126,2020-09-30,Leggett & Platt,LEG,,126900000,104800000,105300000,267400000,145900000,145900000,-20900000,22000000,1207600000,1061700000,940200000,-19000000,104900000,104800000
1127,2020-06-30,Leggett & Platt,LEG,,2400000,-6100000,97100000,146300000,32900000,32900000,-21400000,8500000,845100000,812200000,698800000,-30500000,-6100000,-6100000
1128,2021-07-02,Leidos,LDOS,,223000000,169000000,224000000,498000000,275000000,275000000,-46000000,53000000,3448000000,3173000000,2950000000,-52000000,170000000,169000000
1129,2021-04-02,Leidos,LDOS,,262000000,205000000,159000000,467000000,308000000,308000000,-45000000,57000000,3315000000,3007000000,2848000000,-46000000,205000000,205000000
1130,2021-01-01,Leidos,LDOS,,245000000,197000000,187000000,491000000,302000000,302000000,-49000000,48000000,3252000000,2950000000,2761000000,-57000000,197000000,197000000
1131,2020-10-02,Leidos,LDOS,,214000000,163000000,200000000,468000000,266000000,266000000,-44000000,51000000,3242000000,2976000000,2774000000,-52000000,163000000,163000000
1132,2021-05-31,Lennar,LEN,,1096885000,831363000,545881000,1703804000,1035991000,1035991000,,260113000,6430245000,5394254000,4726441000,60894000,836772000,820279000
1133,2021-02-28,Lennar,LEN,,1327014000,1001369000,520767000,1384255000,876463000,876463000,,310105000,5325468000,4449005000,3941213000,450551000,1016909000,989115000
1134,2020-11-30,Lennar,LEN,,1164646000,882760000,570522000,1717361000,1156899000,1156899000,-22401000,273737000,6825890000,5668991000,5108529000,7747000,890909000,872818000
1135,2020-08-31,Lennar,LEN,,859013000,666418000,528610000,1410208000,869165000,869165000,-22401000,189690000,5870254000,5001089000,4460046000,-10152000,669323000,658620000
1136,2021-06-30,Lincoln National,LNC,,772000000,642000000,,858000000,858000000,858000000,-65000000,130000000,4851000000,3993000000,3993000000,-86000000,642000000,642000000
1137,2021-03-31,Lincoln National,LNC,,262000000,225000000,,340000000,340000000,340000000,-65000000,37000000,4534000000,4194000000,4194000000,-78000000,225000000,225000000
1138,2020-12-31,Lincoln National,LNC,,89000000,143000000,2565000000,3215000000,198000000,198000000,-66000000,-54000000,4136000000,3938000000,921000000,-109000000,143000000,143000000
1139,2020-09-30,Lincoln National,LNC,,460000000,398000000,2565000000,546000000,546000000,546000000,-66000000,62000000,5361000000,4815000000,4815000000,-86000000,398000000,398000000
1140,2021-06-30,Linde,LIN,34000000,1210000000,841000000,773000000,3390000000,1392000000,1392000000,-18000000,334000000,7584000000,6192000000,4194000000,-182000000,876000000,841000000
1141,2021-03-31,Linde,LIN,35000000,1285000000,980000000,738000000,3189000000,1250000000,1250000000,-18000000,268000000,7243000000,5993000000,4054000000,35000000,1017000000,980000000
1142,2020-12-31,Linde,LIN,38000000,1056000000,770000000,756000000,3186000000,1206000000,1206000000,-156000000,253000000,7272000000,6066000000,4086000000,-150000000,803000000,770000000
1143,2020-09-30,Linde,LIN,36000000,995000000,700000000,729000000,3020000000,1055000000,1055000000,-38000000,265000000,6855000000,5800000000,3835000000,-60000000,730000000,700000000
1144,2021-06-30,Live Nation Entertainment,LYV,,-208175000,-195665000,356492000,332826000,-127313000,-127313000,-68909000,2285000,575946000,703259000,243120000,-80862000,-210460000,-194714000
1145,2021-03-31,Live Nation Entertainment,LYV,,-316333000,-307193000,350801000,156643000,-303034000,-303034000,-70830000,6389000,290609000,593643000,133966000,-13299000,-322722000,-308109000
1146,2020-12-31,Live Nation Entertainment,LYV,,-443284000,-443332000,326725000,34109000,-404490000,-404490000,-64051000,20542000,237383000,641873000,203274000,-38794000,-463826000,-436197000
1147,2020-09-30,Live Nation Entertainment,LYV,,-559362000,-528902000,437564000,53269000,-504233000,-504233000,-66093000,-16904000,184018000,688251000,130749000,-55129000,-542458000,-521912000
1148,2021-03-31,LKQ Corporation,LKQ,,359301000,265913000,857921000,1293551000,369829000,369829000,-24718000,92969000,3170786000,2800957000,1877235000,-10528000,266332000,265913000
1149,2020-12-31,LKQ Corporation,LKQ,,249899000,181012000,815386000,1170496000,282715000,282715000,-19012000,68708000,2953888000,2671173000,1783392000,-32816000,181191000,181012000
1150,2020-09-30,LKQ Corporation,LKQ,,272441000,193483000,817958000,1199375000,312762000,312762000,-27878000,78510000,3047684000,2734922000,1848309000,-40321000,193931000,193483000
1151,2020-06-30,LKQ Corporation,LKQ,,160362000,118792000,740093000,1016669000,210829000,210829000,-28412000,41869000,2626323000,2415494000,1609654000,-50467000,118493000,118792000
1152,2021-06-27,Lockheed Martin,LMT,,2170000000,1815000000,-107000000,2151000000,2254000000,2254000000,-142000000,355000000,17029000000,14775000000,14878000000,-84000000,1815000000,1815000000
1153,2021-03-28,Lockheed Martin,LMT,,2211000000,1837000000,-106000000,2222000000,2329000000,2329000000,-140000000,374000000,16258000000,13929000000,14036000000,-118000000,1837000000,1837000000
1154,2020-12-31,Lockheed Martin,LMT,,2187000000,1792000000,-60000000,2241000000,2258000000,2258000000,-149000000,395000000,17032000000,14774000000,14791000000,-71000000,1792000000,1792000000
1155,2020-09-27,Lockheed Martin,LMT,,2056000000,1698000000,-59000000,2136000000,2201000000,2201000000,-145000000,303000000,16495000000,14294000000,14359000000,-145000000,1753000000,1698000000
1156,2021-06-30,Loews Corporation,L,,1012000000,754000000,656000000,1768000000,1112000000,1112000000,-100000000,219000000,4003000000,2891000000,2235000000,-100000000,793000000,754000000
1157,2021-03-31,Loews Corporation,L,,407000000,261000000,914000000,1446000000,532000000,532000000,-125000000,114000000,3622000000,3090000000,2176000000,-125000000,293000000,261000000
1158,2020-12-31,Loews Corporation,L,,548000000,397000000,893000000,1524000000,631000000,631000000,-111000000,111000000,3675000000,3044000000,2151000000,-83000000,437000000,397000000
1159,2020-09-30,Loews Corporation,L,,183000000,139000000,866000000,1196000000,330000000,330000000,-137000000,21000000,3465000000,3135000000,2269000000,-147000000,162000000,139000000
1160,2021-07-30,Lowe's,LOW,,3994000000,3018000000,4666000000,9312000000,4237000000,4237000000,-220000000,976000000,27570000000,23333000000,18258000000,-243000000,3018000000,3007000000
1161,2021-04-30,Lowe's,LOW,,3034000000,2321000000,4494000000,8130000000,3245000000,3245000000,-214000000,713000000,24422000000,21177000000,16292000000,-211000000,2321000000,2312000000
1162,2021-01-29,Lowe's,LOW,,1320000000,978000000,3307000000,6466000000,2769000000,2769000000,-210000000,342000000,20311000000,17542000000,13845000000,-1449000000,978000000,974000000
1163,2020-10-30,Lowe's,LOW,,894000000,692000000,4770000000,7300000000,2175000000,2175000000,-227000000,202000000,22309000000,20134000000,15009000000,-1281000000,692000000,689000000
1164,2021-06-30,Lumen Technologies,LUMN,,674000000,506000000,735000000,2809000000,1043000000,1043000000,-384000000,168000000,4924000000,3881000000,2115000000,-369000000,506000000,506000000
1165,2021-03-31,Lumen Technologies,LUMN,,632000000,475000000,732000000,2893000000,1011000000,1011000000,-389000000,157000000,5029000000,4018000000,2136000000,-379000000,475000000,475000000
1166,2020-12-31,Lumen Technologies,LUMN,,-2208000000,-2289000000,713000000,2894000000,986000000,986000000,-396000000,81000000,5125000000,4139000000,2231000000,-3194000000,-2289000000,-2289000000
1167,2020-09-30,Lumen Technologies,LUMN,,480000000,366000000,852000000,2931000000,886000000,886000000,-409000000,114000000,5167000000,4281000000,2236000000,-406000000,366000000,366000000
1168,2021-09-30,LyondellBasell,LYB,30000000,2213000000,1760000000,327000000,2591000000,2234000000,2234000000,-128000000,452000000,12700000000,10466000000,10109000000,-21000000,1761000000,1756000000
1169,2021-06-30,LyondellBasell,LYB,32000000,2562000000,2058000000,340000000,2885000000,2513000000,2513000000,-131000000,506000000,11561000000,9048000000,8676000000,49000000,2056000000,2052000000
1170,2021-03-31,LyondellBasell,LYB,29000000,1140000000,1068000000,302000000,1404000000,1073000000,1073000000,-112000000,70000000,9082000000,8009000000,7678000000,67000000,1070000000,1066000000
1171,2020-12-31,LyondellBasell,LYB,34000000,894000000,853000000,298000000,1225000000,893000000,893000000,-190000000,39000000,7937000000,7044000000,6712000000,1000000,855000000,853000000
1172,2021-06-30,M&T Bank,MTB,,605628000,458069000,656650000,1470973000,0,630134000,,147559000,1470973000,840839000,0,-24506000,458069000,438756000
1173,2021-03-31,M&T Bank,MTB,,592549000,447249000,713245000,1511993000,0,609475000,,145300000,1511993000,902518000,0,-16926000,447249000,428091000
1174,2020-12-31,M&T Bank,MTB,,620522000,471140000,654539000,1465530000,0,638855000,,149382000,1465530000,826675000,0,-18333000,471140000,451863000
1175,2020-09-30,M&T Bank,MTB,,486882000,372136000,645914000,1313656000,0,502917000,,114746000,1313656000,810739000,0,-16035000,372136000,353399000
1176,2021-06-30,Marathon Oil,MRO,,26000000,16000000,69000000,966000000,54000000,54000000,-59000000,10000000,1259000000,1205000000,293000000,-28000000,16000000,16000000
1177,2021-03-31,Marathon Oil,MRO,,107000000,97000000,75000000,907000000,87000000,87000000,-13000000,10000000,1180000000,1093000000,273000000,20000000,97000000,97000000
1178,2020-12-31,Marathon Oil,MRO,,-341000000,-338000000,57000000,530000000,-215000000,-215000000,-72000000,-3000000,831000000,1046000000,301000000,-126000000,-338000000,-338000000
1179,2020-09-30,Marathon Oil,MRO,,-310000000,-317000000,59000000,452000000,-239000000,-239000000,-62000000,7000000,764000000,1003000000,312000000,-71000000,-317000000,-317000000
1180,2021-06-30,Marathon Petroleum,MPC,,593000000,8512000000,681000000,2557000000,816000000,816000000,-318000000,5000000,29734000000,28918000000,27177000000,-223000000,588000000,8512000000
1181,2021-03-31,Marathon Petroleum,MPC,,-136000000,-242000000,575000000,1704000000,123000000,123000000,-334000000,34000000,22788000000,22665000000,21084000000,-259000000,-170000000,-242000000
1182,2020-12-31,Marathon Petroleum,MPC,,57000000,285000000,639000000,1989000000,380000000,380000000,-334000000,-193000000,18020000000,17640000000,16031000000,-323000000,250000000,284000000
1183,2020-09-30,Marathon Petroleum,MPC,,-1416000000,-886000000,679000000,1287000000,-400000000,-400000000,-344000000,-436000000,17430000000,17830000000,16143000000,-1016000000,-980000000,-886000000
1184,2021-06-30,MarketAxess,MKTX,,86053000,67288000,24784000,125058000,87177000,87177000,-171000,18765000,176334000,89157000,51276000,-1124000,67288000,67288000
1185,2021-03-31,MarketAxess,MKTX,,101801000,80457000,22082000,137340000,103479000,103479000,-191000,21344000,195464000,91985000,58124000,-1678000,80457000,80457000
1186,2020-12-31,MarketAxess,MKTX,,90289000,72931000,22543000,125952000,92817000,92817000,-96000,17358000,171346000,78529000,45394000,-2528000,72931000,72931000
1187,2020-09-30,MarketAxess,MKTX,,87965000,67776000,21171000,118006000,87803000,87803000,-1046000,20189000,164006000,76203000,46000000,162000,67776000,67776000
1188,2021-03-31,Marriott International,MAR,,-27000000,-11000000,211000000,401000000,85000000,85000000,-107000000,-16000000,536000000,451000000,135000000,-112000000,-11000000,-11000000
1189,2020-12-31,Marriott International,MAR,,-314000000,-164000000,459000000,358000000,145000000,145000000,-112000000,-150000000,508000000,363000000,150000000,-459000000,-164000000,-164000000
1190,2020-09-30,Marriott International,MAR,,127000000,100000000,131000000,331000000,253000000,253000000,-113000000,27000000,465000000,212000000,134000000,-126000000,100000000,100000000
1191,2020-06-30,Marriott International,MAR,,-298000000,-234000000,178000000,141000000,-133000000,-133000000,-127000000,-64000000,262000000,395000000,121000000,-165000000,-234000000,-234000000
1192,2021-03-31,Marsh & McLennan,MMC,,1322000000,983000000,,2349000000,1452000000,1452000000,-118000000,324000000,5083000000,3631000000,2734000000,-130000000,998000000,983000000
1193,2020-12-31,Marsh & McLennan,MMC,,540000000,374000000,,1865000000,760000000,760000000,-128000000,161000000,4416000000,3656000000,2551000000,-220000000,379000000,374000000
1194,2020-09-30,Marsh & McLennan,MMC,,459000000,316000000,,1533000000,600000000,600000000,-128000000,139000000,3968000000,3368000000,2435000000,-141000000,320000000,316000000
1195,2020-06-30,Marsh & McLennan,MMC,,787000000,572000000,,1823000000,948000000,948000000,-132000000,207000000,4189000000,3241000000,2366000000,-161000000,580000000,572000000
1196,2021-06-30,Martin Marietta Materials,MLM,,288100000,225800000,76700000,385300000,310200000,310200000,-28100000,62300000,1295300000,985100000,910000000,-22100000,225800000,225600000
1197,2021-03-31,Martin Marietta Materials,MLM,,81400000,65300000,73600000,175900000,106700000,106700000,-27400000,15900000,921900000,815200000,746000000,-25300000,65500000,65300000
1198,2020-12-31,Martin Marietta Materials,MLM,,208300000,183000000,86300000,326200000,239300000,239300000,-28400000,25200000,1110900000,871600000,784700000,-31000000,183100000,182900000
1199,2020-09-30,Martin Marietta Materials,MLM,,375900000,294400000,68200000,404600000,334000000,334000000,-28700000,81500000,1240700000,906700000,836100000,41900000,294400000,294100000
1200,2021-03-31,Masco,MAS,,157000000,94000000,346000000,700000000,354000000,354000000,-202000000,43000000,1970000000,1616000000,1270000000,-208000000,114000000,88000000
1201,2020-12-31,Masco,MAS,,275000000,195000000,353000000,662000000,309000000,309000000,-34000000,67000000,1860000000,1551000000,1198000000,-34000000,208000000,195000000
1202,2020-09-30,Masco,MAS,,380000000,275000000,337000000,752000000,415000000,415000000,-40000000,87000000,1983000000,1568000000,1231000000,-35000000,293000000,274000000
1203,2020-06-30,Masco,MAS,,302000000,224000000,297000000,628000000,331000000,331000000,-35000000,82000000,1764000000,1433000000,1136000000,-29000000,220000000,222000000
1204,2021-06-30,Mastercard,MA,,2478000000,2066000000,1934000000,4528000000,2408000000,2408000000,-106000000,412000000,4528000000,2120000000,0,70000000,2066000000,2066000000
1205,2021-03-31,Mastercard,MA,,2190000000,1828000000,1795000000,4155000000,2197000000,2197000000,-107000000,362000000,4155000000,1958000000,0,-7000000,1828000000,1828000000
1206,2020-12-31,Mastercard,MA,,2168000000,1785000000,1859000000,4120000000,2111000000,2111000000,-108000000,383000000,4120000000,2009000000,0,57000000,1785000000,1785000000
1207,2020-09-30,Mastercard,MA,,1915000000,1513000000,1591000000,3837000000,2105000000,2105000000,-105000000,402000000,3837000000,1732000000,0,-190000000,1513000000,1513000000
1208,2021-06-30,Match Group,MTCH,52133000,177340000,140895000,238811000,514661000,213414000,213414000,-32219000,37320000,707760000,494346000,193099000,-36074000,140020000,140895000
1209,2021-03-31,Match Group,MTCH,55576000,156101000,174250000,228653000,488157000,193258000,193258000,-31838000,-17747000,667612000,474354000,179455000,-37157000,173848000,174250000
1210,2020-12-31,Match Group,MTCH,44832000,165796000,140579000,213007000,481671000,212582000,212582000,-43306000,25617000,651407000,438825000,169736000,-46786000,140179000,140579000
1211,2020-09-30,Match Group,MTCH,39280000,155055000,132581000,218820000,469947000,200167000,200167000,-43189000,23568000,639770000,439603000,169823000,-45112000,131487000,132581000
1212,2021-08-31,McCormick & Company,MKC,,243900000,212400000,325800000,599600000,273800000,273800000,-33900000,31500000,1549400000,1275600000,949800000,-29900000,212400000,212400000
1213,2021-05-31,McCormick & Company,MKC,,229100000,183700000,355200000,614600000,259400000,259400000,-35600000,45400000,1556700000,1297300000,942100000,-30300000,183700000,183700000
1214,2021-02-28,McCormick & Company,MKC,,220400000,161800000,319500000,583800000,264300000,264300000,-33800000,58600000,1481500000,1217200000,897700000,-43900000,161800000,161800000
1215,2020-11-30,McCormick & Company,MKC,68600000,258200000,200700000,299000000,660700000,293100000,293100000,-32400000,57500000,1557900000,1264800000,897200000,-34900000,200700000,200700000
1216,2021-06-30,McDonald's,MCD,,2376000000,2219300000,572400000,3219500000,2564000000,2564000000,-296500000,156700000,5887900000,3323900000,2668400000,-188000000,2219300000,2219300000
1217,2021-03-31,McDonald's,MCD,,1952700000,1537200000,490400000,2668300000,2108500000,2108500000,-300000000,415500000,5124600000,3016100000,2456300000,-155800000,1537200000,1537200000
1218,2020-12-31,McDonald's,MCD,,1830000000,1377200000,698000000,2780200000,2016000000,2016000000,-308900000,452800000,5313800000,3297800000,2533600000,-186000000,1377200000,1377200000
1219,2020-09-30,McDonald's,MCD,,2217100000,1762600000,454700000,2904700000,2401200000,2401200000,-310100000,454500000,5418100000,3016900000,2513400000,-184100000,1762600000,1762600000
1220,2021-03-31,McKesson Corporation,MCK,,1029000000,666000000,2224000000,3116000000,892000000,892000000,-52000000,316000000,59142000000,58250000000,56026000000,137000000,713000000,666000000
1221,2020-12-31,McKesson Corporation,MCK,,-7363000000,-6226000000,2291000000,3151000000,860000000,860000000,-55000000,-1189000000,62599000000,61739000000,59448000000,-8223000000,-6174000000,-6226000000
1222,2020-09-30,McKesson Corporation,MCK,,655000000,577000000,2237000000,3000000000,763000000,763000000,-50000000,28000000,60808000000,60045000000,57808000000,-108000000,627000000,577000000
1223,2020-06-30,McKesson Corporation,MCK,,645000000,444000000,2097000000,2700000000,603000000,603000000,-60000000,150000000,55679000000,55076000000,52979000000,42000000,495000000,444000000
1224,2021-07-30,Medtronic,MDT,750000000,833000000,763000000,2491000000,5422000000,1665000000,1665000000,-137000000,64000000,7987000000,6322000000,2565000000,-832000000,769000000,763000000
1225,2021-04-30,Medtronic,MDT,632000000,1566000000,1360000000,2510000000,5568000000,1980000000,1980000000,-142000000,200000000,8188000000,6208000000,2620000000,-414000000,1366000000,1360000000
1226,2021-01-29,Medtronic,MDT,601000000,1220000000,1270000000,2481000000,5190000000,1652000000,1652000000,-143000000,-59000000,7775000000,6123000000,2585000000,-432000000,1279000000,1270000000
1227,2020-10-30,Medtronic,MDT,639000000,525000000,489000000,2612000000,4974000000,1134000000,1134000000,-470000000,31000000,7647000000,6513000000,2673000000,-609000000,494000000,489000000
1228,2021-06-30,Merck & Co.,MRK,2611000000,1717000000,1545000000,2144000000,8373000000,3618000000,3618000000,-202000000,503000000,11402000000,7784000000,3029000000,-1901000000,1214000000,1545000000
1229,2021-03-31,Merck & Co.,MRK,2458000000,3462000000,3179000000,2333000000,8625000000,3834000000,3834000000,-200000000,276000000,12080000000,8246000000,3455000000,-372000000,3186000000,3179000000
1230,2020-12-31,Merck & Co.,MRK,2617000000,-1993000000,-2094000000,2993000000,8914000000,3304000000,3304000000,-207000000,98000000,12515000000,9211000000,3601000000,-5297000000,-2091000000,-2094000000
1231,2020-09-30,Merck & Co.,MRK,2539000000,3428000000,2941000000,2109000000,9108000000,4460000000,4460000000,-203000000,483000000,12551000000,8091000000,3443000000,-1032000000,2945000000,2941000000
1232,2021-06-30,MetLife,MET,,4487000000,3407000000,,7368000000,4714000000,4714000000,-228000000,1075000000,18524000000,13810000000,11156000000,-227000000,3412000000,3366000000
1233,2021-03-31,MetLife,MET,,291000000,358000000,,3441000000,519000000,519000000,-228000000,-72000000,15562000000,15043000000,12121000000,-228000000,363000000,290000000
1234,2020-12-31,MetLife,MET,,164000000,158000000,,3588000000,393000000,393000000,-230000000,6000000,19418000000,19025000000,15830000000,-229000000,158000000,124000000
1235,2020-09-30,MetLife,MET,,923000000,706000000,,4393000000,1152000000,1152000000,-229000000,214000000,16015000000,14863000000,11622000000,-229000000,709000000,633000000
1236,2021-03-31,Mettler Toledo,MTD,39272000,185414000,149663000,219215000,471696000,199325000,199325000,-9471000,35751000,804390000,605065000,332694000,-13911000,149663000,149663000
1237,2020-12-31,Mettler Toledo,MTD,39866000,269180000,216295000,223208000,559044000,281313000,281313000,-9505000,52885000,937985000,656672000,378941000,-12133000,216295000,216295000
1238,2020-09-30,Mettler Toledo,MTD,34656000,205809000,161767000,201873000,469608000,218958000,218958000,-9310000,44042000,807357000,588399000,337749000,-13149000,161767000,161767000
1239,2020-06-30,Mettler Toledo,MTD,31193000,155255000,126562000,187182000,397970000,165706000,165706000,-9582000,28693000,690673000,524967000,292703000,-10451000,126562000,126562000
1240,2021-06-30,MGM Resorts International,MGM,,125130000,104753000,687079000,1122310000,151516000,151516000,-208772000,34826000,2192829000,2041313000,1070519000,-26386000,90304000,67742000
1241,2021-03-31,MGM Resorts International,MGM,,-430636000,-331829000,624444000,719960000,-195040000,-195040000,-160295000,-94698000,1589686000,1784726000,869726000,-235596000,-335938000,-341257000
1242,2020-12-31,MGM Resorts International,MGM,,-562872000,-447605000,618495000,582876000,-334349000,-334349000,-185679000,-106904000,1395287000,1729636000,812411000,-228523000,-455968000,-454113000
1243,2020-09-30,MGM Resorts International,MGM,,-678705000,-534731000,613730000,396403000,-511701000,-511701000,-173808000,-76734000,1093603000,1605304000,697200000,-167004000,-601971000,-532954000
1244,2021-06-30,Microchip Technology,MCHP,238400000,297000000,252800000,173700000,1007600000,379900000,379900000,-72300000,44200000,1569400000,1189500000,561800000,-82900000,252800000,252800000
1245,2021-03-31,Microchip Technology,MCHP,228500000,144400000,116000000,164200000,926800000,301700000,301700000,-78000000,28400000,1467100000,1165400000,540300000,-157300000,116000000,116000000
1246,2020-12-31,Microchip Technology,MCHP,210100000,16800000,36200000,154500000,845800000,249600000,249600000,-86500000,-19400000,1352100000,1102500000,506300000,-232800000,36200000,36200000
1247,2020-09-30,Microchip Technology,MCHP,199800000,88800000,73600000,145000000,807900000,230200000,230200000,-93300000,15200000,1309500000,1079300000,501600000,-141400000,73600000,73600000
1248,2021-03-04,Micron Technology,MU,641000000,651000000,603000000,214000000,1649000000,663000000,663000000,-42000000,48000000,6236000000,5573000000,4587000000,-12000000,603000000,603000000
1249,2020-12-03,Micron Technology,MU,647000000,854000000,803000000,214000000,1736000000,866000000,866000000,-48000000,51000000,5773000000,4907000000,4037000000,-12000000,803000000,803000000
1250,2020-09-03,Micron Technology,MU,630000000,1126000000,988000000,231000000,2068000000,1204000000,1204000000,-50000000,136000000,6056000000,4852000000,3988000000,-78000000,990000000,988000000
1251,2020-05-28,Micron Technology,MU,649000000,873000000,803000000,216000000,1763000000,892000000,892000000,-51000000,68000000,5438000000,4546000000,3675000000,-19000000,805000000,803000000
1252,2021-06-30,Microsoft,MSFT,5687000000,19405000000,16458000000,7379000000,32161000000,19095000000,19095000000,-549000000,2947000000,46152000000,27057000000,13991000000,310000000,16458000000,16458000000
1253,2021-03-31,Microsoft,MSFT,5204000000,17236000000,15457000000,6409000000,28661000000,17048000000,17048000000,-628000000,1779000000,41706000000,24658000000,13045000000,188000000,15457000000,15457000000
1254,2020-12-31,Microsoft,MSFT,4899000000,18337000000,15463000000,6086000000,28882000000,17897000000,17897000000,-568000000,2874000000,43076000000,25179000000,14194000000,440000000,15463000000,15463000000
1255,2020-09-30,Microsoft,MSFT,4926000000,16124000000,13893000000,5350000000,26152000000,15876000000,15876000000,-585000000,2231000000,37154000000,21278000000,11002000000,248000000,13893000000,13893000000
1256,2021-06-30,Mid-America Apartments,MAA,,225920000,216478000,13114000,254414000,109476000,109476000,-38867000,2045000,436927000,327451000,182513000,116444000,223875000,215322000
1257,2021-03-31,Mid-America Apartments,MAA,,49863000,47193000,12979000,249598000,105116000,105116000,-39672000,999000,425005000,319889000,175407000,-55253000,48864000,46217000
1258,2020-12-31,Mid-America Apartments,MAA,,87094000,83342000,11677000,250411000,109149000,109149000,-40952000,795000,423661000,314512000,173250000,-22055000,86299000,82311000
1259,2020-09-30,Mid-America Apartments,MAA,,62701000,59910000,11360000,240694000,101655000,101655000,-41010000,665000,423199000,321544000,182505000,-38954000,62036000,58910000
1260,2021-06-30,Moderna,MRNA,,3063000000,2780000000,121000000,3183000000,3062000000,3062000000,-5000000,283000000,4354000000,1292000000,1171000000,1000000,2780000000,2780000000
1261,2021-03-31,Moderna,MRNA,,1260000000,1221000000,77000000,1343000000,1266000000,1266000000,-3000000,39000000,1937000000,671000000,594000000,-6000000,1221000000,1221000000
1262,2020-12-31,Moderna,MRNA,,-271012000,-272485000,78990000,-196048000,-275038000,-275038000,-3508000,1473000,570745000,845783000,766793000,4026000,-272485000,-272485000
1263,2020-09-30,Moderna,MRNA,,-232772000,-233636000,48541000,-186576000,-235117000,-235117000,-2834000,864000,157910000,393027000,344486000,2345000,-233636000,-233636000
1264,2021-07-03,Mohawk Industries,MHK,,400698000,336285000,496302000,907506000,411204000,411204000,-14894000,64245000,2953833000,2542629000,2046327000,-10506000,336453000,336285000
1265,2021-04-03,Mohawk Industries,MHK,,304501000,236807000,473252000,801951000,328699000,328699000,-15241000,67690000,2669026000,2340327000,1867075000,-24198000,236811000,236807000
1266,2020-12-31,Mohawk Industries,MHK,,273577000,248221000,452079000,760931000,308852000,308852000,-15898000,25180000,2641764000,2332912000,1880833000,-35275000,248397000,248221000
1267,2020-09-26,Mohawk Industries,MHK,,248616000,205117000,434691000,723909000,289218000,289218000,-14854000,43163000,2574870000,2285652000,1850961000,-40602000,205453000,205117000
1268,2021-06-30,Molson Coors Beverage Company,TAP,,522600000,388600000,668700000,1271500000,602800000,602800000,-70700000,132300000,2939400000,2336600000,1667900000,-80200000,390300000,388600000
1269,2021-03-31,Molson Coors Beverage Company,TAP,,126300000,84100000,529900000,731000000,201100000,201100000,-68200000,44300000,1898400000,1697300000,1167400000,-74800000,82000000,84100000
1270,2020-12-31,Molson Coors Beverage Company,TAP,,-1337300000,-1369800000,640700000,895200000,254500000,254500000,-56800000,36600000,2294300000,2039800000,1399100000,-1591800000,-1373900000,-1369800000
1271,2020-09-30,Molson Coors Beverage Company,TAP,,450400000,342800000,626900000,1202500000,575600000,575600000,-70700000,104000000,2753500000,2177900000,1551000000,-125200000,346400000,342800000
1272,2021-06-30,Mondelez International,MDLZ,,1477000000,1078000000,1525000000,2631000000,1074000000,1074000000,-87000000,398000000,6642000000,5568000000,4011000000,403000000,1079000000,1078000000
1273,2021-03-31,Mondelez International,MDLZ,,1180000000,961000000,1515000000,2966000000,1413000000,1413000000,-95000000,212000000,7238000000,5825000000,4272000000,-233000000,968000000,961000000
1274,2020-12-31,Mondelez International,MDLZ,,1503000000,1156000000,1599000000,2872000000,1222000000,1222000000,-90000000,344000000,7298000000,6076000000,4426000000,281000000,1159000000,1156000000
1275,2020-09-30,Mondelez International,MDLZ,,1513000000,1119000000,1446000000,2792000000,1296000000,1296000000,-104000000,391000000,6665000000,5369000000,3873000000,217000000,1122000000,1119000000
1276,2021-06-30,Monolithic Power Systems,MPWR,44753000,63659000,55169000,57238000,164215000,62224000,62224000,,8490000,293317000,231093000,129102000,1435000,55169000,55169000
1277,2021-03-31,Monolithic Power Systems,MPWR,41892000,48673000,45413000,51453000,141059000,47714000,47714000,,3260000,254455000,206741000,113396000,959000,45413000,45413000
1278,2020-12-31,Monolithic Power Systems,MPWR,42252000,44442000,42887000,45120000,128874000,41502000,41502000,,1555000,233043000,191541000,104169000,2940000,42887000,42887000
1279,2020-09-30,Monolithic Power Systems,MPWR,37717000,62473000,55566000,43503000,143040000,61820000,61820000,,6907000,259422000,197602000,116382000,653000,55566000,55566000
1280,2021-06-30,Monster Beverage,MNST,,526847000,403762000,310741000,836838000,525975000,525975000,-5000,123085000,1461934000,935959000,625096000,872000,403762000,403762000
1281,2021-03-31,Monster Beverage,MNST,,413387000,315194000,300655000,714935000,414146000,414146000,-4000,98193000,1243816000,829670000,528881000,-759000,315194000,315194000
1282,2020-12-31,Monster Beverage,MNST,,400796000,471736000,382595000,690685000,402301000,402301000,-4000,-70940000,1196283000,793982000,505598000,-1505000,471736000,471736000
1283,2020-09-30,Monster Beverage,MNST,,454033000,347654000,277753000,736531000,458601000,458601000,-1268000,106379000,1246362000,787761000,509831000,-4568000,347654000,347654000
1284,2021-06-30,Moody's Corporation,MCO,,758000000,577000000,321000000,1188000000,807000000,807000000,-46000000,181000000,1553000000,746000000,365000000,-49000000,577000000,577000000
1285,2021-03-31,Moody's Corporation,MCO,,862000000,736000000,293000000,1207000000,855000000,855000000,-46000000,126000000,1600000000,745000000,393000000,7000000,736000000,736000000
1286,2020-12-31,Moody's Corporation,MCO,,400000000,314000000,334000000,881000000,490000000,490000000,-15000000,86000000,1290000000,800000000,409000000,-90000000,314000000,314000000
1287,2020-09-30,Moody's Corporation,MCO,,599000000,467000000,272000000,992000000,664000000,664000000,-51000000,132000000,1356000000,692000000,364000000,-65000000,467000000,467000000
1288,2021-09-30,Morgan Stanley,MS,,4874000000,3707000000,7208000000,13140000000,0,5908000000,,1150000000,14753000000,8845000000,1613000000,-1034000000,3724000000,3584000000
1289,2021-06-30,Morgan Stanley,MS,,4566000000,3511000000,7704000000,13199000000,0,5422000000,,1054000000,14759000000,9337000000,1560000000,-856000000,3512000000,3408000000
1290,2021-03-31,Morgan Stanley,MS,,5344000000,4120000000,7940000000,14076000000,0,6234000000,,1176000000,15719000000,9485000000,1643000000,-890000000,4168000000,3982000000
1291,2020-12-31,Morgan Stanley,MS,,4430000000,3385000000,6595000000,12167000000,0,5572000000,,1018000000,13640000000,8068000000,1473000000,-1142000000,3412000000,3266000000
1292,2021-07-03,Motorola Solutions,MSI,181000000,340000000,293000000,300000000,955000000,474000000,474000000,-46000000,46000000,1971000000,1497000000,1016000000,-134000000,294000000,293000000
1293,2021-04-03,Motorola Solutions,MSI,180000000,289000000,244000000,273000000,862000000,351000000,351000000,-56000000,44000000,1773000000,1422000000,911000000,-62000000,245000000,244000000
1294,2020-12-31,Motorola Solutions,MSI,181000000,522000000,412000000,321000000,1151000000,592000000,592000000,-58000000,109000000,2273000000,1681000000,1122000000,-70000000,413000000,412000000
1295,2020-09-26,Motorola Solutions,MSI,175000000,251000000,205000000,293000000,912000000,390000000,390000000,-60000000,45000000,1868000000,1478000000,956000000,-139000000,206000000,205000000
1296,2021-06-30,MSCI,MSCI,27531000,195695000,165423000,88373000,410853000,273546000,273546000,-39557000,30272000,498180000,224634000,87327000,-77851000,165423000,165423000
1297,2021-03-31,MSCI,MSCI,24862000,216028000,196819000,91195000,392643000,254375000,254375000,-37584000,19209000,478423000,224048000,85780000,-38347000,196819000,196819000
1298,2020-12-31,MSCI,MSCI,27056000,195166000,156216000,85569000,367726000,232671000,232671000,-37330000,38950000,443661000,210990000,75935000,-37505000,156216000,156216000
1299,2020-09-30,MSCI,MSCI,24901000,189043000,182358000,80281000,354629000,227620000,227620000,-37536000,6685000,425333000,197713000,70704000,-38577000,182358000,182358000
1300,2021-06-30,Nasdaq,NDAQ,,454000000,341000000,362000000,846000000,416000000,416000000,-33000000,113000000,1412000000,996000000,566000000,38000000,341000000,341000000
1301,2021-03-31,Nasdaq,NDAQ,,395000000,298000000,361000000,851000000,427000000,427000000,-29000000,97000000,1652000000,1225000000,801000000,-32000000,298000000,298000000
1302,2020-12-31,Nasdaq,NDAQ,,267000000,225000000,376000000,788000000,359000000,359000000,-24000000,42000000,1462000000,1103000000,674000000,-92000000,225000000,225000000
1303,2020-09-30,Nasdaq,NDAQ,,357000000,264000000,318000000,715000000,346000000,346000000,-24000000,93000000,1414000000,1068000000,699000000,11000000,264000000,264000000
1304,2021-04-30,NetApp,NTAP,221000000,436000000,334000000,513000000,1035000000,301000000,301000000,-19000000,102000000,1555000000,1254000000,520000000,135000000,334000000,334000000
1305,2021-01-29,NetApp,NTAP,215000000,247000000,182000000,499000000,975000000,261000000,261000000,-19000000,65000000,1470000000,1209000000,495000000,-14000000,182000000,182000000
1306,2020-10-30,NetApp,NTAP,212000000,175000000,137000000,494000000,933000000,227000000,227000000,-18000000,38000000,1416000000,1189000000,483000000,-52000000,137000000,137000000
1307,2020-07-31,NetApp,NTAP,233000000,104000000,77000000,490000000,872000000,149000000,149000000,-18000000,27000000,1303000000,1154000000,431000000,-45000000,77000000,77000000
1308,2021-03-31,Netflix,NFLX,525207000,2034502000,1706715000,809708000,3294771000,1959856000,1959856000,-194440000,327787000,7163282000,5203426000,3868511000,74646000,1706715000,1706715000
1309,2020-12-31,Netflix,NFLX,486936000,506417000,542156000,1038104000,2479282000,954242000,954242000,-197186000,-35739000,6644442000,5690200000,4165160000,-447825000,542156000,542156000
1310,2020-09-30,Netflix,NFLX,453802000,861460000,789976000,799221000,2567886000,1314863000,1314863000,-197079000,71484000,6435637000,5120774000,3867751000,-453403000,789976000,789976000
1311,2020-06-30,Netflix,NFLX,435045000,1035602000,720196000,711606000,2504579000,1357928000,1357928000,-189151000,315406000,6148286000,4790358000,3643707000,-322326000,720196000,720196000
1312,2021-06-30,Newell Brands,NWL,,243000000,197000000,570000000,882000000,312000000,312000000,-65000000,46000000,2709000000,2397000000,1827000000,-69000000,197000000,197000000
1313,2021-03-31,Newell Brands,NWL,,126000000,89000000,533000000,731000000,198000000,198000000,-67000000,37000000,2288000000,2090000000,1557000000,-72000000,89000000,89000000
1314,2020-12-31,Newell Brands,NWL,144000000,101000000,127000000,496000000,888000000,248000000,248000000,-69000000,-26000000,2689000000,2441000000,1801000000,-147000000,127000000,127000000
1315,2020-09-30,Newell Brands,NWL,144000000,283000000,304000000,545000000,914000000,369000000,369000000,-71000000,-21000000,2699000000,2330000000,1785000000,-86000000,304000000,304000000
1316,2021-06-30,Newmont,NEM,37000000,992000000,650000000,71000000,1732000000,1012000000,1012000000,-68000000,341000000,3065000000,2053000000,1333000000,-20000000,651000000,650000000
1317,2021-03-31,Newmont,NEM,31000000,793000000,559000000,65000000,1593000000,905000000,905000000,-74000000,235000000,2872000000,1967000000,1279000000,-112000000,558000000,559000000
1318,2020-12-31,Newmont,NEM,30000000,1004000000,824000000,71000000,1777000000,1080000000,1080000000,-73000000,258000000,3381000000,2301000000,1604000000,-76000000,746000000,824000000
1319,2020-09-30,Newmont,NEM,39000000,933000000,839000000,151000000,1869000000,1043000000,1043000000,-75000000,305000000,3170000000,2127000000,1301000000,-110000000,628000000,839000000
1320,2021-06-30,News Corp (Class A),NWSA,,-107000000,-14000000,1046000000,1261000000,39000000,39000000,-28000000,-92000000,2492000000,2453000000,1231000000,-146000000,-15000000,-14000000
1321,2021-03-31,News Corp (Class A),NWSA,,139000000,79000000,848000000,1149000000,128000000,128000000,-7000000,43000000,2335000000,2207000000,1186000000,11000000,96000000,79000000
1322,2020-12-31,News Corp (Class A),NWSA,,346000000,231000000,716000000,1216000000,333000000,333000000,-12000000,85000000,2414000000,2081000000,1198000000,13000000,261000000,231000000
1323,2020-09-30,News Corp (Class A),NWSA,,72000000,34000000,683000000,953000000,106000000,106000000,-8000000,25000000,2117000000,2011000000,1164000000,-34000000,47000000,34000000
1324,2021-06-30,News Corp (Class B),NWS,,-107000000,-14000000,1046000000,1261000000,39000000,39000000,-28000000,-92000000,2492000000,2453000000,1231000000,-146000000,-15000000,-14000000
1325,2021-03-31,News Corp (Class B),NWS,,139000000,79000000,848000000,1149000000,128000000,128000000,-7000000,43000000,2335000000,2207000000,1186000000,11000000,96000000,79000000
1326,2020-12-31,News Corp (Class B),NWS,,346000000,231000000,716000000,1216000000,333000000,333000000,-12000000,85000000,2414000000,2081000000,1198000000,13000000,261000000,231000000
1327,2020-09-30,News Corp (Class B),NWS,,72000000,34000000,683000000,953000000,106000000,106000000,-8000000,25000000,2117000000,2011000000,1164000000,-34000000,47000000,34000000
1328,2021-06-30,NextEra Energy,NEE,,-68000000,256000000,-64000000,1958000000,581000000,581000000,-757000000,-140000000,3927000000,3346000000,1969000000,-649000000,72000000,256000000
1329,2021-03-31,NextEra Energy,NEE,,1748000000,1666000000,-64000000,1831000000,719000000,719000000,-757000000,250000000,3726000000,3007000000,1895000000,1029000000,1498000000,1666000000
1330,2020-12-31,NextEra Energy,NEE,,-225000000,-5000000,-51000000,2424000000,1100000000,1100000000,-111000000,-35000000,4395000000,3295000000,1971000000,-1325000000,-190000000,-5000000
1331,2020-09-30,NextEra Energy,NEE,,1252000000,1229000000,-50000000,2752000000,1069000000,1069000000,-208000000,129000000,4785000000,3716000000,2033000000,183000000,1123000000,1229000000
1332,2021-06-30,Nielsen Holdings,NLSN,,124000000,76000000,218000000,569000000,225000000,225000000,-69000000,36000000,861000000,636000000,292000000,-101000000,88000000,76000000
1333,2021-03-31,Nielsen Holdings,NLSN,,169000000,573000000,206000000,586000000,253000000,253000000,-80000000,60000000,863000000,610000000,277000000,-84000000,109000000,573000000
1334,2020-12-31,Nielsen Holdings,NLSN,,61000000,35000000,460000000,960000000,291000000,291000000,-94000000,25000000,1672000000,1381000000,712000000,-230000000,36000000,35000000
1335,2020-09-30,Nielsen Holdings,NLSN,,79000000,7000000,451000000,900000000,232000000,232000000,-92000000,69000000,1563000000,1331000000,663000000,-153000000,10000000,7000000
1336,2021-02-28,Nike,NKE,,1636000000,1449000000,3018000000,4725000000,1707000000,1707000000,-72000000,187000000,10357000000,8650000000,5632000000,-71000000,1449000000,1449000000
1337,2020-11-30,Nike,NKE,,1456000000,1251000000,3160000000,4877000000,1717000000,1717000000,-76000000,205000000,11243000000,9526000000,6366000000,-261000000,1251000000,1251000000
1338,2020-08-31,Nike,NKE,,1715000000,1518000000,2835000000,4741000000,1906000000,1906000000,-72000000,197000000,10594000000,8688000000,5853000000,-191000000,1518000000,1518000000
1339,2020-05-31,Nike,NKE,,-804000000,-790000000,3191000000,2353000000,-838000000,-838000000,-61000000,-14000000,6313000000,7151000000,3960000000,34000000,-790000000,-790000000
1340,2021-06-30,NiSource,NI,,70100000,60300000,-8600000,394900000,150700000,150700000,-84500000,13200000,986000000,835300000,591100000,-80600000,56900000,46500000
1341,2021-03-31,NiSource,NI,,359100000,296500000,-8500000,711900000,454400000,454400000,-84600000,62600000,1545600000,1091200000,833700000,-95300000,296500000,282700000
1342,2020-12-31,NiSource,NI,,144600000,84400000,17400000,517700000,241900000,241900000,-92900000,56800000,1211000000,969100000,693300000,-97300000,87800000,70700000
1343,2020-09-30,NiSource,NI,,-237800000,-172900000,-600000,402900000,152700000,152700000,-95200000,-64900000,902500000,749800000,499600000,-390500000,-172900000,-186700000
1344,2021-03-31,Norfolk Southern,NSC,,866000000,673000000,,1332000000,1040000000,1040000000,-156000000,193000000,2639000000,1599000000,1307000000,-174000000,673000000,672000000
1345,2020-12-31,Norfolk Southern,NSC,,867000000,671000000,,1294000000,1007000000,1007000000,-160000000,196000000,2573000000,1566000000,1279000000,-140000000,671000000,671000000
1346,2020-09-30,Norfolk Southern,NSC,,724000000,569000000,,1156000000,863000000,863000000,-155000000,155000000,2506000000,1643000000,1350000000,-139000000,569000000,567000000
1347,2020-06-30,Norfolk Southern,NSC,,503000000,392000000,,915000000,633000000,633000000,-156000000,111000000,2085000000,1452000000,1170000000,-130000000,392000000,392000000
1348,2021-06-30,Northern Trust,NTRS,,486500000,368100000,1062200000,1607300000,0,486500000,,118400000,1607300000,1120800000,0,0,368100000,360200000
1349,2021-03-31,Northern Trust,NTRS,,495900000,375100000,1053700000,1613400000,0,495900000,,120800000,1613400000,1117500000,0,0,375100000,355200000
1350,2020-12-31,Northern Trust,NTRS,,373400000,240900000,1035500000,1524400000,0,425900000,,132500000,1524400000,1098500000,0,-52500000,240900000,234700000
1351,2020-09-30,Northern Trust,NTRS,,389900000,294500000,991100000,1484600000,0,389900000,,95400000,1484600000,1094700000,0,0,294500000,275000000
1352,2021-06-30,Northrop Grumman,NOC,,1302000000,1037000000,632000000,2043000000,1411000000,1411000000,-136000000,265000000,9151000000,7740000000,7108000000,-109000000,1037000000,1037000000
1353,2021-03-31,Northrop Grumman,NOC,,3016000000,2195000000,531000000,1740000000,1209000000,1209000000,-155000000,821000000,9157000000,7948000000,7417000000,1807000000,2195000000,2195000000
1354,2020-12-31,Northrop Grumman,NOC,,305000000,330000000,1681000000,2090000000,409000000,409000000,-160000000,-25000000,10212000000,9803000000,8122000000,-104000000,330000000,330000000
1355,2020-09-30,Northrop Grumman,NOC,,1167000000,986000000,553000000,1840000000,1287000000,1287000000,-154000000,181000000,9083000000,7796000000,7243000000,-120000000,986000000,986000000
1356,2021-07-02,NortonLifeLock,NLOK,68000000,252000000,181000000,201000000,584000000,294000000,294000000,-32000000,71000000,686000000,392000000,102000000,-42000000,181000000,181000000
1357,2021-04-02,NortonLifeLock,NLOK,68000000,289000000,194000000,200000000,573000000,285000000,285000000,-35000000,81000000,672000000,387000000,99000000,4000000,208000000,194000000
1358,2021-01-01,NortonLifeLock,NLOK,71000000,253000000,178000000,182000000,552000000,281000000,281000000,-32000000,80000000,639000000,358000000,87000000,-28000000,173000000,178000000
1359,2020-10-02,NortonLifeLock,NLOK,63000000,231000000,64000000,186000000,536000000,269000000,269000000,-37000000,65000000,626000000,357000000,90000000,-38000000,166000000,64000000
1360,2021-03-31,Norwegian Cruise Line Holdings,NCLH,,-1368464000,-1370192000,203293000,-197755000,-571364000,-571364000,-150422000,1728000,3100000,574464000,200855000,-797100000,-1370192000,-1370192000
1361,2020-12-31,Norwegian Cruise Line Holdings,NCLH,,-707409000,-738933000,186666000,-197413000,-546982000,-546982000,-159205000,31524000,9579000,556561000,206992000,-160427000,-738933000,-738933000
1362,2020-09-30,Norwegian Cruise Line Holdings,NCLH,,-681127000,-677366000,156656000,-183639000,-517783000,-517783000,-133028000,-3761000,6518000,524301000,190157000,-163344000,-677366000,-677366000
1363,2020-06-30,Norwegian Cruise Line Holdings,NCLH,,-724366000,-715243000,131436000,-284723000,-595411000,-595411000,-93378000,-9123000,16929000,612340000,301652000,-128955000,-715243000,-715243000
1364,2021-03-31,NRG Energy,NRG,,-167000000,-82000000,330000000,1227000000,-31000000,-31000000,-127000000,-85000000,8091000000,8122000000,6864000000,-136000000,-82000000,-82000000
1365,2020-12-31,NRG Energy,NRG,2000000,-138000000,-173000000,246000000,412000000,47000000,47000000,-109000000,35000000,2027000000,1980000000,1615000000,-185000000,-173000000,-173000000
1366,2020-09-30,NRG Energy,NRG,1000000,341000000,249000000,253000000,775000000,422000000,422000000,-99000000,92000000,2809000000,2387000000,2034000000,-81000000,249000000,249000000
1367,2020-06-30,NRG Energy,NRG,2000000,414000000,313000000,208000000,804000000,484000000,484000000,-96000000,101000000,2238000000,1754000000,1434000000,-70000000,313000000,313000000
1368,2021-07-03,Nucor,NUE,,2025748000,1506868000,387070000,2473503000,2086433000,2086433000,-35780000,454289000,8789164000,6702731000,6315661000,-60685000,1571459000,1506868000
1369,2021-04-03,Nucor,NUE,,1298246000,942432000,291124000,1622437000,1331313000,1331313000,-40970000,310732000,7017140000,5685827000,5394703000,-33067000,987514000,937056000
1370,2020-12-31,Nucor,NUE,,217766000,398843000,175078000,739487000,537409000,537409000,-37887000,-208100000,5260055000,4722646000,4520568000,-319643000,425866000,396669000
1371,2020-10-03,Nucor,NUE,,290418000,193415000,149113000,502195000,353082000,353082000,-42281000,67788000,4927960000,4574878000,4425765000,-62664000,222630000,192214000
1372,2021-08-01,Nvidia,NVDA,1245000000,2394000000,2374000000,526000000,4215000000,2444000000,2444000000,-60000000,20000000,6507000000,4063000000,2292000000,-50000000,2374000000,2374000000
1373,2021-05-02,Nvidia,NVDA,1153000000,2044000000,1912000000,520000000,3629000000,1956000000,1956000000,-53000000,132000000,5661000000,3705000000,2032000000,88000000,1912000000,1912000000
1374,2021-01-31,Nvidia,NVDA,1146000000,1470000000,1457000000,502000000,3156000000,1508000000,1508000000,-53000000,13000000,5003000000,3495000000,1847000000,-38000000,1457000000,1457000000
1375,2020-10-25,Nvidia,NVDA,1047000000,1348000000,1336000000,515000000,2960000000,1398000000,1398000000,-53000000,12000000,4726000000,3328000000,1766000000,-50000000,1336000000,1336000000
1376,2021-06-30,NVR,NVR,,417465000,321295000,113406000,536521000,423115000,423115000,-12850000,96170000,2287439000,1864324000,1750918000,-5650000,321295000,321295000
1377,2021-03-31,NVR,NVR,,312006000,248762000,121419000,446431000,325012000,325012000,-13006000,63244000,2045064000,1720052000,1598633000,-13006000,248762000,248762000
1378,2020-12-31,NVR,NVR,,385370000,305004000,112398000,503637000,391239000,391239000,-12769000,80366000,2353606000,1962367000,1849969000,-5869000,305004000,305004000
1379,2020-09-30,NVR,NVR,,321457000,256466000,105741000,433707000,327966000,327966000,-11309000,64991000,1994222000,1666256000,1560515000,-6509000,256466000,256466000
1380,2021-07-04,NXP,NXPI,475000000,471000000,397000000,234000000,1422000000,574000000,574000000,-90000000,65000000,2596000000,2022000000,1174000000,-103000000,406000000,397000000
1381,2021-04-04,NXP,NXPI,461000000,404000000,353000000,222000000,1355000000,492000000,492000000,-87000000,40000000,2567000000,2075000000,1212000000,-88000000,364000000,353000000
1382,2020-12-31,NXP,NXPI,438000000,325000000,309000000,215000000,1288000000,527000000,527000000,-86000000,5000000,2507000000,1980000000,1219000000,-202000000,320000000,309000000
1383,2020-09-27,NXP,NXPI,431000000,-75000000,-22000000,201000000,1102000000,53000000,53000000,-100000000,-57000000,2267000000,2214000000,1165000000,-128000000,-18000000,-22000000
1384,2021-03-31,O'Reilly Automotive,ORLY,,655827000,501609000,949690000,1640795000,691105000,691105000,-37506000,154218000,3090899000,2399794000,1450104000,-35278000,501609000,501609000
1385,2020-12-31,O'Reilly Automotive,ORLY,,499929000,392945000,631466000,1472138000,537672000,537672000,-38349000,106984000,2828773000,2291101000,1356635000,-37743000,392945000,392945000
1386,2020-09-30,O'Reilly Automotive,ORLY,,686406000,527252000,955455000,1680468000,725013000,725013000,-41668000,159154000,3207638000,2482625000,1527170000,-38607000,527252000,527252000
1387,2020-06-30,O'Reilly Automotive,ORLY,,700410000,531667000,900690000,1637180000,736490000,736490000,-41723000,168743000,3091595000,2355105000,1454415000,-36080000,531667000,531667000
1388,2021-06-30,Occidental Petroleum,OXY,,143000000,103000000,177000000,3719000000,572000000,572000000,-608000000,43000000,5958000000,5386000000,2239000000,-429000000,100000000,-97000000
1389,2021-03-31,Occidental Petroleum,OXY,,315000000,-146000000,166000000,3036000000,45000000,45000000,4000000,16000000,5293000000,5248000000,2257000000,270000000,299000000,-346000000
1390,2020-12-31,Occidental Petroleum,OXY,,-1425000000,-1112000000,209000000,2200000000,-352000000,-352000000,-260000000,-276000000,4160000000,4512000000,1960000000,-1073000000,-1149000000,-1312000000
1391,2020-09-30,Occidental Petroleum,OXY,,-4058000000,-3575000000,166000000,2158000000,-384000000,-384000000,-265000000,-403000000,4108000000,4492000000,1950000000,-3674000000,-3655000000,-3778000000
1392,2021-09-30 00:00:00,Old Dominion Freight Line,ODFL,,382951000,286634000,52986000,543077000,383410000,383410000,-371000,96317000,1400046000,1016636000,856969000,-459000,286634000,286634000
1393,2021-06-30 00:00:00,Old Dominion Freight Line,ODFL,,364388000,269576000,49410000,517997000,366044000,366044000,-465000,94812000,1319409000,953365000,801412000,-1656000,269576000,269576000
1394,2021-03-31 00:00:00,Old Dominion Freight Line,ODFL,,269308000,199359000,44090000,413790000,269657000,269657000,-507000,69949000,1126515000,856858000,712725000,-349000,199359000,199359000
1395,2020-12-31 00:00:00,Old Dominion Freight Line,ODFL,,253323000,189832000,33190000,388259000,254302000,254302000,-846000,63491000,1073389000,819087000,685130000,-979000,189832000,189832000
1396,2021-09-30 00:00:00,Omnicom Group,OMC,,500100000,355600000,95000000,687700000,541600000,541600000,-50700000,120000000,3435000000,2893400000,2747300000,-41500000,380100000,355600000
1397,2021-06-30 00:00:00,Omnicom Group,OMC,,494800000,348200000,103200000,674600000,517900000,517900000,-80300000,123200000,3571600000,3053700000,2897000000,-23100000,371600000,348200000
1398,2021-03-31 00:00:00,Omnicom Group,OMC,,417900000,287800000,71600000,590300000,465400000,465400000,-53800000,111900000,3426900000,2961500000,2836600000,-47500000,306000000,287800000
1399,2020-12-31 00:00:00,Omnicom Group,OMC,,570000000,398100000,101300000,626900000,471800000,471800000,-19100000,141500000,3757000000,3285200000,3130100000,98200000,428500000,398100000
1400,2021-09-30 00:00:00,Oneok,OKE,,513917000,392018000,231226000,1087048000,661527000,661527000,-184049000,121899000,4536175000,3874648000,3449127000,-147610000,392018000,391743000
1401,2021-06-30 00:00:00,Oneok,OKE,,452208000,342139000,219101000,1021985000,604023000,604023000,-184957000,110069000,3388964000,2784941000,2366979000,-151815000,342139000,341864000
1402,2021-03-31 00:00:00,Oneok,OKE,,508308000,386176000,212100000,1073169000,659510000,659510000,-185523000,122132000,3194679000,2535169000,2121510000,-151202000,386176000,385901000
1403,2020-12-31 00:00:00,Oneok,OKE,,403236000,308029000,227019000,943491000,536447000,536447000,-176931000,95207000,2570577000,2034130000,1627086000,-133211000,308029000,307754000
1404,2021-08-31 00:00:00,Oracle,ORCL,1684000000,2681000000,2457000000,2152000000,7625000000,3470000000,3470000000,-705000000,224000000,9728000000,6258000000,2103000000,-789000000,2457000000,2457000000
1405,2021-05-31 00:00:00,Oracle,ORCL,1715000000,4156000000,4032000000,2382000000,9105000000,4637000000,4637000000,-694000000,124000000,11227000000,6590000000,2122000000,-481000000,4032000000,4032000000
1406,2021-02-28 00:00:00,Oracle,ORCL,1621000000,3276000000,5021000000,2245000000,8170000000,3947000000,3947000000,-580000000,-1745000000,10085000000,6138000000,1915000000,-671000000,5021000000,5021000000
1407,2020-11-30 00:00:00,Oracle,ORCL,1601000000,2972000000,2442000000,2160000000,7861000000,3680000000,3680000000,-601000000,530000000,9800000000,6120000000,1939000000,-708000000,2442000000,2442000000
1408,2021-06-30 00:00:00,Organon & Co.,OGN,76000000,437000000,427000000,416000000,1012000000,520000000,520000000,-62000000,6000000,1595000000,1075000000,583000000,-83000000,431000000,427000000
1409,2021-03-31 00:00:00,Organon & Co.,OGN,67000000,467000000,399000000,382000000,915000000,466000000,466000000,-62000000,72000000,1506000000,1040000000,591000000,1000000,395000000,399000000
1410,2020-06-30 00:00:00,Organon & Co.,OGN,51000000,702000000,542000000,284000000,1066000000,731000000,731000000,-62000000,116000000,1526000000,795000000,460000000,-29000000,586000000,542000000
1411,2020-03-31 00:00:00,Organon & Co.,OGN,45000000,844000000,703000000,317000000,1242000000,880000000,880000000,-62000000,110000000,1780000000,900000000,538000000,-36000000,734000000,703000000
1412,2021-09-30 00:00:00,Otis Worldwide,OTIS,39000000,507000000,331000000,477000000,1065000000,545000000,545000000,-34000000,128000000,3620000000,3075000000,2555000000,-38000000,379000000,331000000
1413,2021-06-30 00:00:00,Otis Worldwide,OTIS,39000000,532000000,326000000,485000000,1085000000,570000000,570000000,-27000000,153000000,3701000000,3131000000,2616000000,-38000000,379000000,326000000
1414,2021-03-31 00:00:00,Otis Worldwide,OTIS,35000000,475000000,308000000,464000000,1023000000,532000000,532000000,-32000000,123000000,3408000000,2876000000,2385000000,-57000000,352000000,308000000
1415,2020-12-31 00:00:00,Otis Worldwide,OTIS,40000000,397000000,251000000,481000000,993000000,475000000,475000000,-37000000,118000000,3493000000,3018000000,2500000000,-78000000,279000000,251000000
1416,2021-09-30 00:00:00,Paccar,PCAR,72500000,483300000,377700000,115200000,677700000,490000000,490000000,-9400000,105600000,5146800000,4656800000,4469100000,-6700000,377700000,377700000
1417,2021-06-30 00:00:00,Paccar,PCAR,84400000,637000000,492900000,113200000,831400000,633800000,633800000,-9400000,144100000,5843900000,5210100000,5012500000,3200000,492900000,492900000
1418,2021-03-31 00:00:00,Paccar,PCAR,80100000,607300000,470100000,109800000,799200000,609300000,609300000,-10400000,137200000,5845500000,5236200000,5046300000,-2000000,470100000,470100000
1419,2020-12-31 00:00:00,Paccar,PCAR,71700000,521800000,405800000,120700000,712800000,520400000,520400000,-10400000,116000000,5568600000,5048200000,4855800000,1400000,405800000,405800000
1420,2021-09-30 00:00:00,Packaging Corporation of America,PKG,,333900000,250700000,139500000,513700000,371100000,371100000,-23900000,83200000,2000100000,1629000000,1486400000,-37200000,250700000,249000000
1421,2021-06-30 00:00:00,Packaging Corporation of America,PKG,,274700000,207300000,141300000,450800000,307500000,307500000,-24900000,67400000,1879900000,1572400000,1429100000,-32800000,207300000,205500000
1422,2021-03-31 00:00:00,Packaging Corporation of America,PKG,,219600000,166500000,140200000,404200000,260900000,260900000,-23500000,53100000,1807200000,1546300000,1403000000,-41300000,166500000,165200000
1423,2020-12-31 00:00:00,Packaging Corporation of America,PKG,,165400000,123600000,129700000,334300000,203300000,203300000,-24400000,41800000,1714200000,1510900000,1379900000,-37900000,123600000,122700000
1424,2021-09-30 00:00:00,Parker-Hannifin,PH,,571745000,451157000,390633000,1050912000,660279000,660279000,-59350000,120282000,3762809000,3102530000,2711897000,-88534000,451463000,451157000
1425,2021-06-30 00:00:00,Parker-Hannifin,PH,,657798000,505738000,421864000,1131835000,709971000,709971000,-60258000,151884000,3958869000,3248898000,2827034000,-52173000,505914000,505738000
1426,2021-03-31 00:00:00,Parker-Hannifin,PH,,597352000,471647000,392824000,1034609000,641785000,641785000,-60830000,125619000,3746326000,3104541000,2711717000,-44433000,471733000,471647000
1427,2020-12-31 00:00:00,Parker-Hannifin,PH,,576512000,447306000,363184000,907360000,544176000,544176000,-62990000,129015000,3411905000,2867729000,2504545000,32336000,447497000,447306000
1428,2021-08-31 00:00:00,Paychex,PAYX,,443900000,333600000,327500000,770400000,442900000,442900000,-9200000,110300000,1082900000,640000000,312500000,1000000,333600000,333600000
1429,2021-05-31 00:00:00,Paychex,PAYX,,345900000,263000000,359600000,713400000,353800000,353800000,-8100000,82900000,1029200000,675400000,315800000,-7700000,263000000,263000000
1430,2021-02-28 00:00:00,Paychex,PAYX,,462600000,350500000,314700000,783300000,468600000,468600000,-8800000,112100000,1111700000,643100000,328400000,-6000000,350500000,350500000
1431,2020-11-30 00:00:00,Paychex,PAYX,,349600000,272400000,309500000,663800000,354300000,354300000,-9000000,77200000,983700000,629400000,319900000,-4700000,272400000,272400000
1432,2021-09-30 00:00:00,Paycom,PAYC,31077000,43549000,30379000,129725000,221428000,43305000,43305000,158000,13170000,256194000,212889000,34766000,244000,30379000,30379000
1433,2021-06-30 00:00:00,Paycom,PAYC,28224000,47236000,52278000,122042000,213373000,47090000,47090000,49000,-5042000,242146000,195056000,28773000,146000,52278000,52278000
1434,2021-03-31 00:00:00,Paycom,PAYC,24711000,95175000,64616000,108952000,243125000,94546000,94546000,656000,30559000,272198000,177652000,29073000,629000,64616000,64616000
1435,2020-12-31 00:00:00,Paycom,PAYC,25073000,36601000,24367000,119201000,194820000,36247000,36247000,656000,12234000,220947000,184700000,26127000,354000,24367000,24367000
1436,2021-09-30 00:00:00,PayPal,PYPL,755000000,1165000000,1087000000,1047000000,2846000000,1043000000,1043000000,,78000000,6182000000,5139000000,3336000000,122000000,1087000000,1087000000
1437,2021-06-30 00:00:00,PayPal,PYPL,746000000,1356000000,1184000000,1150000000,3024000000,1128000000,1128000000,-57000000,172000000,6238000000,5110000000,3214000000,228000000,1184000000,1184000000
1438,2021-03-31 00:00:00,PayPal,PYPL,741000000,872000000,1097000000,1126000000,2967000000,1100000000,1100000000,-58000000,-225000000,6033000000,4933000000,3066000000,-228000000,1097000000,1097000000
1439,2020-12-31 00:00:00,PayPal,PYPL,732000000,1859000000,1567000000,1174000000,2913000000,1007000000,1007000000,-59000000,292000000,6116000000,5109000000,3203000000,852000000,1567000000,1567000000
1440,2021-09-30 00:00:00,Penn National Gaming,PENN,,122500000,86100000,362700000,743300000,252900000,252900000,-145200000,36400000,1511800000,1258900000,768500000,-130400000,86100000,85700000
1441,2021-06-30 00:00:00,Penn National Gaming,PENN,,251800000,198700000,313000000,776300000,381400000,381400000,-138200000,53100000,1545800000,1164400000,769500000,-129600000,198700000,197700000
1442,2021-03-31 00:00:00,Penn National Gaming,PENN,,111500000,91000000,326100000,624000000,216600000,216600000,-135900000,20600000,1274900000,1058300000,650900000,-105100000,90900000,90500000
1443,2020-12-31 00:00:00,Penn National Gaming,PENN,,19800000,11100000,300800000,520400000,128200000,128200000,-136300000,7100000,1027400000,899200000,507000000,-108400000,12700000,11100000
1444,2021-09-30 00:00:00,Pentair,PNR,21900000,165800000,143600000,141600000,334800000,171300000,171300000,-2600000,22100000,969200000,797900000,634400000,-5500000,143700000,143600000
1445,2021-06-30 00:00:00,Pentair,PNR,21000000,157700000,132100000,152100000,341000000,167900000,167900000,-3800000,25100000,941100000,773200000,600100000,-10200000,132600000,132100000
1446,2021-03-31 00:00:00,Pentair,PNR,21500000,151600000,128600000,135500000,315200000,158200000,158200000,-5100000,20500000,865900000,707700000,550700000,-6600000,131100000,128600000
1447,2020-12-31 00:00:00,Pentair,PNR,20100000,110700000,103000000,142300000,285500000,123100000,123100000,-3900000,10900000,796000000,672900000,510500000,-12400000,99800000,103000000
1448,2021-09-30 00:00:00,People's United Financial,PBCT,,169400000,139700000,252500000,458600000,0,184900000,,29700000,458600000,273700000,0,-15500000,139700000,136200000
1449,2021-06-30 00:00:00,People's United Financial,PBCT,,215700000,170800000,261900000,518700000,0,241300000,,44900000,518700000,277400000,0,-25600000,170800000,167300000
1450,2021-03-31 00:00:00,People's United Financial,PBCT,,182200000,144500000,257000000,495900000,0,221600000,,37700000,495900000,274300000,0,-39400000,144500000,141000000
1451,2020-12-31 00:00:00,People's United Financial,PBCT,,-100100000,-145300000,232900000,545400000,0,311800000,,45200000,545400000,233600000,0,-411900000,-145300000,-148900000
1452,2021-09-04 00:00:00,PepsiCo,PEP,,3045000000,2224000000,7464000000,10804000000,3340000000,3340000000,-232000000,802000000,20189000000,16849000000,9385000000,-295000000,2243000000,2224000000
1453,2021-06-12 00:00:00,PepsiCo,PEP,,3014000000,2358000000,7049000000,10340000000,3292000000,3292000000,-194000000,642000000,19217000000,15925000000,8877000000,-278000000,2372000000,2358000000
1454,2021-03-20 00:00:00,PepsiCo,PEP,,2174000000,1714000000,5852000000,8151000000,2300000000,2300000000,-258000000,451000000,14820000000,12520000000,6669000000,-126000000,1723000000,1714000000
1455,2020-12-26 00:00:00,PepsiCo,PEP,719000000,2357000000,1845000000,8492000000,12057000000,2856000000,2856000000,-339000000,498000000,22455000000,19599000000,10398000000,-499000000,1859000000,1845000000
1456,2021-10-03 00:00:00,PerkinElmer,PKI,68608000,161668000,127738000,286097000,641261000,286556000,286556000,-43531000,33883000,1166684000,880128000,525423000,-124888000,127785000,127738000
1457,2021-07-04 00:00:00,PerkinElmer,PKI,65824000,326057000,245930000,267182000,687494000,354488000,354488000,-16750000,80089000,1228471000,873983000,540977000,-28431000,245968000,245930000
1458,2021-04-04 00:00:00,PerkinElmer,PKI,60216000,480482000,379305000,237770000,788127000,490141000,490141000,-14126000,101139000,1307689000,817548000,519562000,-9659000,379343000,379305000
1459,2021-01-03 00:00:00,PerkinElmer,PKI,56823000,473091000,380361000,281970000,836038000,497245000,497245000,-11904000,92657000,1354606000,857361000,518568000,-24154000,380434000,380361000
1460,2021-10-03 00:00:00,Pfizer,PFE,2739000000,7836000000,8146000000,1600000000,14163000000,8843000000,8843000000,-325000000,-331000000,24094000000,15251000000,9931000000,-1007000000,8167000000,8146000000
1461,2021-07-04 00:00:00,Pfizer,PFE,2271000000,6608000000,5563000000,2552000000,11985000000,6231000000,6231000000,-316000000,1043000000,18977000000,12746000000,6992000000,377000000,5565000000,5563000000
1462,2021-04-04 00:00:00,Pfizer,PFE,2011000000,5682000000,4877000000,2385000000,10410000000,5142000000,5142000000,-336000000,805000000,14582000000,9440000000,4172000000,540000000,4877000000,4877000000
1463,2020-12-31 00:00:00,Pfizer,PFE,2828000000,178000000,594000000,3481000000,8797000000,1632000000,1632000000,-347000000,-170000000,11684000000,10052000000,2887000000,-1454000000,348000000,594000000
1464,2021-09-30 00:00:00,Philip Morris International,PM,,3323000000,2426000000,2037000000,5526000000,3471000000,3471000000,-201000000,735000000,8122000000,4651000000,2596000000,-148000000,2588000000,2419000000
1465,2021-06-30 00:00:00,Philip Morris International,PM,,2944000000,2172000000,2041000000,5241000000,3181000000,3181000000,-211000000,646000000,7594000000,4413000000,2353000000,-237000000,2298000000,2166000000
1466,2021-03-31 00:00:00,Philip Morris International,PM,,3292000000,2418000000,1829000000,5311000000,3464000000,3464000000,-209000000,697000000,7585000000,4121000000,2274000000,-172000000,2595000000,2411000000
1467,2020-12-31 00:00:00,Philip Morris International,PM,,2732000000,1976000000,1900000000,4872000000,2954000000,2954000000,-73000000,613000000,7444000000,4490000000,2572000000,-222000000,2119000000,1971000000
1468,2021-09-30 00:00:00,Phillips 66,PSX,,448000000,402000000,1590000000,2717000000,686000000,686000000,-151000000,-40000000,30246000000,29560000000,27529000000,-238000000,488000000,400000000
1469,2021-06-30 00:00:00,Phillips 66,PSX,,436000000,296000000,1608000000,1817000000,-262000000,-262000000,-143000000,62000000,27035000000,27297000000,25218000000,698000000,374000000,291000000
1470,2021-03-31 00:00:00,Phillips 66,PSX,,-771000000,-654000000,1788000000,1577000000,-712000000,-712000000,-146000000,-132000000,21642000000,22354000000,20065000000,-59000000,-639000000,-656000000
1471,2020-12-31 00:00:00,Phillips 66,PSX,,-691000000,-539000000,1612000000,1262000000,-799000000,-799000000,-139000000,-197000000,16412000000,17211000000,15150000000,108000000,-494000000,-541000000
1472,2021-09-30 00:00:00,Pinnacle West Capital,PNW,,415967000,339798000,79553000,756104000,457508000,457508000,-64067000,71863000,1308254000,850746000,552150000,-41541000,344104000,339798000
1473,2021-06-30 00:00:00,Pinnacle West Capital,PNW,,265996000,215697000,-28175000,500724000,306561000,306561000,-62777000,46560000,1000249000,693688000,499525000,-40565000,219436000,215697000
1474,2021-03-31 00:00:00,Pinnacle West Capital,PNW,,36164000,35641000,-27791000,268193000,75325000,75325000,-61938000,-4350000,696475000,621150000,428282000,-39161000,40514000,35641000
1475,2020-12-31 00:00:00,Pinnacle West Capital,PNW,,-34431000,-19391000,-185105000,75452000,45018000,45018000,-64080000,-19913000,740961000,695943000,665509000,-79449000,-14518000,-19391000
1476,2021-09-30 00:00:00,Pioneer Natural Resources,PXD,,1336000000,1045000000,72000000,2697000000,1384000000,1384000000,-41000000,291000000,4961000000,3577000000,2264000000,-48000000,1045000000,1042000000
1477,2021-06-30 00:00:00,Pioneer Natural Resources,PXD,,500000000,380000000,75000000,2173000000,592000000,592000000,-41000000,120000000,4269000000,3677000000,2096000000,-92000000,380000000,379000000
1478,2021-03-31 00:00:00,Pioneer Natural Resources,PXD,,-81000000,-70000000,68000000,1444000000,169000000,169000000,-39000000,-11000000,3064000000,2895000000,1620000000,-250000000,-70000000,-70000000
1479,2020-12-31 00:00:00,Pioneer Natural Resources,PXD,,-73000000,-30000000,64000000,745000000,-100000000,-100000000,-35000000,-43000000,2016000000,2116000000,1271000000,27000000,-30000000,-30000000
1480,2021-09-30 00:00:00,PNC Financial Services,PNC,,1813000000,1474000000,2692000000,5400000000,0,1813000000,,323000000,5400000000,3587000000,0,0,1490000000,1408000000
1481,2021-06-30 00:00:00,PNC Financial Services,PNC,,1315000000,1091000000,2257000000,4365000000,0,1315000000,,212000000,4365000000,3050000000,0,0,1103000000,1037000000
1482,2021-03-31 00:00:00,PNC Financial Services,PNC,,2197000000,1816000000,2030000000,4771000000,0,2197000000,,371000000,4771000000,2574000000,0,0,1826000000,1750000000
1483,2020-12-31 00:00:00,PNC Financial Services,PNC,,1754000000,220000000,2096000000,4462000000,0,1754000000,,298000000,4462000000,2708000000,0,0,1456000000,165000000
1484,2021-09-30 00:00:00,Pool Corporation,POOL,,235051000,184665000,206023000,441899000,235876000,235876000,-2317000,50386000,1411448000,1175572000,969549000,-825000,184665000,184665000
1485,2021-06-30 00:00:00,Pool Corporation,POOL,,336680000,259695000,213099000,551685000,338586000,338586000,-1963000,76985000,1787833000,1449247000,1236148000,-1906000,259695000,259695000
1486,2021-03-31 00:00:00,Pool Corporation,POOL,,126524000,98655000,172100000,301131000,129031000,129031000,-2582000,27869000,1060745000,931714000,759614000,-2507000,98655000,98655000
1487,2020-12-31 00:00:00,Pool Corporation,POOL,,71336000,59173000,164745000,239095000,74350000,74350000,-1361000,12163000,839261000,764911000,600166000,-3014000,59173000,59173000
1488,2021-09-30 00:00:00,PPG Industries,PPG,114000000,441000000,344000000,907000000,1639000000,472000000,472000000,-30000000,96000000,4372000000,3900000000,2733000000,-31000000,345000000,344000000
1489,2021-06-30 00:00:00,PPG Industries,PPG,107000000,593000000,431000000,955000000,1730000000,520000000,520000000,-31000000,160000000,4359000000,3839000000,2629000000,73000000,433000000,431000000
1490,2021-03-31 00:00:00,PPG Industries,PPG,102000000,499000000,378000000,891000000,1649000000,513000000,513000000,-30000000,114000000,3881000000,3368000000,2232000000,-14000000,385000000,378000000
1491,2020-12-31 00:00:00,PPG Industries,PPG,100000000,345000000,272000000,916000000,1651000000,414000000,414000000,-31000000,67000000,3757000000,3343000000,2106000000,-69000000,278000000,272000000
1492,2021-09-30 00:00:00,PPL,PPL,,260000000,207000000,,757000000,431000000,431000000,-183000000,51000000,1512000000,1081000000,755000000,-171000000,209000000,207000000
1493,2021-06-30 00:00:00,PPL,PPL,,-191000000,19000000,-8000000,588000000,278000000,278000000,-474000000,345000000,1288000000,1010000000,700000000,-469000000,-536000000,19000000
1494,2021-03-31 00:00:00,PPL,PPL,,262000000,-1840000000,-4000000,734000000,419000000,419000000,-153000000,59000000,1498000000,1079000000,764000000,-157000000,203000000,-1840000000
1495,2020-12-31 00:00:00,PPL,PPL,,369000000,290000000,-60000000,1115000000,766000000,766000000,-251000000,79000000,1929000000,1163000000,814000000,-397000000,290000000,290000000
1496,2021-09-30 00:00:00,Principal Financial Group,PFG,,428100000,359900000,1196500000,1624600000,428100000,428100000,,63800000,3423700000,2995600000,1799100000,0,364300000,359900000
1497,2021-06-30 00:00:00,Principal Financial Group,PFG,,432600000,361800000,1265100000,1697700000,432600000,432600000,,61000000,3539400000,3106800000,1841700000,0,371600000,363700000
1498,2021-03-31 00:00:00,Principal Financial Group,PFG,,613900000,517100000,1201700000,1815600000,613900000,613900000,,97600000,3208500000,2594600000,1392900000,0,516300000,515200000
1499,2020-12-31 00:00:00,Principal Financial Group,PFG,,591600000,472600000,1161800000,1753400000,591600000,591600000,,100100000,3765100000,3173500000,2011700000,0,491500000,472600000
1500,2021-09-30 00:00:00,Procter & Gamble,PG,,5035000000,4112000000,5012000000,9973000000,4961000000,4961000000,-109000000,909000000,20338000000,15377000000,10365000000,74000000,4126000000,4042000000
1501,2021-06-30 00:00:00,Procter & Gamble,PG,,3564000000,2906000000,4616000000,9289000000,4673000000,4673000000,-117000000,656000000,18946000000,14273000000,9657000000,-1109000000,2908000000,2832000000
1502,2021-03-31 00:00:00,Procter & Gamble,PG,,3877000000,3269000000,5402000000,9187000000,3785000000,3785000000,-106000000,628000000,18109000000,14324000000,8922000000,92000000,3249000000,3204000000
1503,2020-12-31 00:00:00,Procter & Gamble,PG,,4877000000,3854000000,5112000000,10492000000,5380000000,5380000000,-143000000,990000000,19745000000,14365000000,9253000000,-503000000,3887000000,3788000000
1504,2021-09-30 00:00:00,Progressive Corporation,PGR,,139000000,118500000,,266000000,193200000,193200000,-54200000,20500000,11852600000,11659400000,11586600000,-54200000,118500000,111800000
1505,2021-06-30 00:00:00,Progressive Corporation,PGR,,999200000,790100000,,1123500000,1055600000,1055600000,-56400000,209100000,11899200000,10843600000,10775700000,-56400000,790100000,783400000
1506,2021-03-31 00:00:00,Progressive Corporation,PGR,,1867900000,1480000000,,1973600000,1924300000,1924300000,-56400000,387900000,11439600000,9515300000,9466000000,-56400000,1480000000,1473300000
1507,2020-12-31 00:00:00,Progressive Corporation,PGR,,2106200000,1684300000,,2228200000,2162400000,2162400000,-56200000,421900000,11410300000,9247900000,9182100000,-56200000,1684300000,1677500000
1508,2021-09-30 00:00:00,Prologis,PLD,,857166000,723538000,66970000,965871000,503682000,503682000,-63638000,59435000,1274867000,771185000,308996000,353484000,797731000,722007000
1509,2021-06-30 00:00:00,Prologis,PLD,,699508000,600176000,74342000,933029000,458757000,458757000,-68412000,49195000,1223261000,764504000,290232000,240751000,650313000,598625000
1510,2021-03-31 00:00:00,Prologis,PLD,,425410000,367347000,78032000,888031000,408980000,408980000,-71281000,25717000,1215365000,806385000,327334000,16430000,399693000,365815000
1511,2020-12-31 00:00:00,Prologis,PLD,,348887000,281894000,66144000,901146000,413499000,413499000,-76856000,40880000,1192123000,778624000,290977000,-64612000,308007000,280470000
1512,2021-09-30 00:00:00,Prudential Financial,PRU,,1824000000,1530000000,3386000000,5192000000,1806000000,1806000000,,259000000,21641000000,19835000000,16449000000,18000000,1565000000,1506000000
1513,2021-06-30 00:00:00,Prudential Financial,PRU,,2792000000,2158000000,3230000000,5943000000,2713000000,2713000000,,609000000,15857000000,13144000000,9914000000,79000000,2183000000,2127000000
1514,2021-03-31 00:00:00,Prudential Financial,PRU,,3440000000,2828000000,3314000000,6726000000,3412000000,3412000000,,636000000,16949000000,13537000000,10223000000,28000000,2804000000,2784000000
1515,2020-12-31 00:00:00,Prudential Financial,PRU,,934000000,819000000,3719000000,4638000000,919000000,919000000,,-88000000,16048000000,15129000000,11410000000,15000000,1022000000,814000000
1516,2021-09-30 00:00:00,PTC,PTC,78403000,169522000,292943000,177887000,380908000,116930000,116930000,,-123421000,480656000,363726000,99748000,52592000,292943000,292943000
1517,2021-06-30 00:00:00,PTC,PTC,78134000,58469000,51203000,180878000,340591000,74068000,74068000,-13178000,7266000,435668000,361600000,95077000,-15599000,51203000,51203000
1518,2021-03-31 00:00:00,PTC,PTC,72545000,86357000,109262000,179673000,372337000,112469000,112469000,-12925000,-22905000,461785000,349316000,89448000,-26112000,109262000,109262000
1519,2020-12-31 00:00:00,PTC,PTC,70835000,77407000,23515000,170337000,342220000,94485000,94485000,-11518000,53892000,429050000,334565000,86830000,-17078000,23515000,23515000
1520,2021-09-30 00:00:00,Public Service Enterprise Group,PEG,,-2246000000,-1564000000,-82000000,249000000,48000000,48000000,-144000000,-682000000,1903000000,1855000000,1654000000,-2294000000,-1564000000,-1564000000
1521,2021-06-30 00:00:00,Public Service Enterprise Group,PEG,,-239000000,-177000000,-82000000,485000000,245000000,245000000,-147000000,-62000000,1874000000,1629000000,1389000000,-484000000,-177000000,-177000000
1522,2021-03-31 00:00:00,Public Service Enterprise Group,PEG,,765000000,648000000,-82000000,1082000000,823000000,823000000,-146000000,117000000,2889000000,2066000000,1807000000,-58000000,648000000,648000000
1523,2020-12-31 00:00:00,Public Service Enterprise Group,PEG,,553000000,431000000,-63000000,761000000,495000000,495000000,-147000000,122000000,2402000000,1907000000,1641000000,58000000,431000000,431000000
1524,2021-09-30 00:00:00,Public Storage,PSA,,491628000,490091000,31682000,691057000,470823000,470823000,-23736000,0,927791000,456968000,236734000,20805000,491628000,442327000
1525,2021-06-30 00:00:00,Public Storage,PSA,,411730000,410426000,27640000,639795000,439327000,439327000,-21994000,0,858381000,419054000,218586000,-27597000,411730000,346249000
1526,2021-03-31 00:00:00,Public Storage,PSA,,434262000,433036000,18374000,558295000,391862000,391862000,-15250000,0,786718000,394856000,228423000,42400000,434262000,385810000
1527,2020-12-31 00:00:00,Public Storage,PSA,,352432000,351267000,20453000,559854000,397895000,397895000,-16036000,0,765378000,367483000,205524000,-45463000,352432000,292166000
1528,2021-09-30 00:00:00,PulteGroup,PHM,,620402000,475549000,320506000,945650000,623044000,623044000,-115000,144853000,3479050000,2856006000,2533400000,-2642000,475549000,471707000
1529,2021-06-30 00:00:00,PulteGroup,PHM,,639473000,503399000,272286000,913238000,636833000,636833000,-138000,136074000,3359484000,2722651000,2446246000,2640000,503399000,499374000
1530,2021-03-31 00:00:00,PulteGroup,PHM,,394052000,304107000,271686000,729746000,455566000,455566000,-135000,89945000,2729791000,2274225000,2000045000,-61514000,304107000,301655000
1531,2020-12-31 00:00:00,PulteGroup,PHM,,523750000,438111000,279757000,811261000,528796000,528796000,-226000,85639000,3192364000,2663568000,2381103000,-5046000,438111000,434234000
1532,2021-08-01 00:00:00,PVH,PVH,,252700000,181900000,1048000000,1333600000,285600000,285600000,-27300000,70900000,2313200000,2027600000,979600000,-32900000,181800000,181900000
1533,2021-05-02 00:00:00,PVH,PVH,,168000000,99900000,984100000,1229100000,245000000,245000000,-30500000,68300000,2079300000,1834300000,850200000,-77000000,99700000,99900000
1534,2021-01-31 00:00:00,PVH,PVH,,-8200000,-57700000,1111200000,1058300000,-52900000,-52900000,-35900000,49900000,2089800000,2142700000,1031500000,44700000,-58100000,-57700000
1535,2020-11-01 00:00:00,PVH,PVH,,88600000,69800000,982900000,1101300000,118400000,118400000,-34400000,19100000,2118100000,1999700000,1016800000,-29800000,69500000,69800000
1536,2021-10-02 00:00:00,Qorvo,QRVO,158377000,351787000,319189000,93489000,621553000,362860000,362860000,-15327000,32598000,1255248000,892388000,633695000,-11073000,319189000,319189000
1537,2021-07-03 00:00:00,Qorvo,QRVO,152079000,298614000,285626000,90299000,546183000,298302000,298302000,-15279000,12988000,1110351000,812049000,564168000,312000,285626000,285626000
1538,2021-04-03 00:00:00,Qorvo,QRVO,147285000,286786000,298737000,78123000,528475000,322258000,322258000,-18339000,-11951000,1072730000,750472000,544255000,-35472000,298737000,298737000
1539,2021-01-02 00:00:00,Qorvo,QRVO,136697000,223516000,201035000,93139000,537752000,300198000,300198000,-17453000,22481000,1094834000,794636000,557082000,-76682000,201035000,201035000
1540,2021-09-26 00:00:00,Qualcomm,QCOM,1879000000,3285000000,2798000000,618000000,5399000000,2902000000,2902000000,-138000000,487000000,9336000000,6434000000,3937000000,383000000,2798000000,2798000000
1541,2021-06-27 00:00:00,Qualcomm,QCOM,1864000000,2257000000,2027000000,597000000,4656000000,2195000000,2195000000,-138000000,230000000,8060000000,5865000000,3404000000,62000000,2027000000,2027000000
1542,2021-03-28 00:00:00,Qualcomm,QCOM,1780000000,2129000000,1762000000,557000000,4503000000,2166000000,2166000000,-141000000,367000000,7935000000,5769000000,3432000000,-37000000,1762000000,1762000000
1543,2020-12-27 00:00:00,Qualcomm,QCOM,1653000000,2604000000,2455000000,567000000,4746000000,2526000000,2526000000,-141000000,149000000,8235000000,5709000000,3489000000,78000000,2455000000,2455000000
1544,2021-09-30 00:00:00,Quanta Services,PWR,,236979000,174365000,274846000,534676000,237058000,237058000,-17259000,61581000,3353278000,3116220000,2818602000,-78999,175398000,174365000
1545,2021-06-30 00:00:00,Quanta Services,PWR,,159922000,117033000,270110000,447711000,156310000,156310000,-13109000,40951000,2999816000,2843506000,2552105000,3612000,118971000,117033000
1546,2021-03-31 00:00:00,Quanta Services,PWR,,105043000,89761000,243352000,372890000,108183000,108183000,-12475000,13724000,2703581000,2595398000,2330691000,-3140000,91319000,89761000
1547,2020-12-31 00:00:00,Quanta Services,PWR,,171722000,170051000,265775000,465873000,178768000,178768000,-11304000,-239000,2912185000,2733417000,2446312000,-7046000,171961000,170051000
1548,2021-09-30 00:00:00,Quest Diagnostics,DGX,,680000000,505000000,421000000,1111000000,665000000,665000000,-38000000,153000000,2774000000,2109000000,1663000000,15000000,527000000,503000000
1549,2021-06-30 00:00:00,Quest Diagnostics,DGX,,827000000,631000000,420000000,997000000,554000000,554000000,-38000000,177000000,2550000000,1996000000,1553000000,273000000,650000000,628000000
1550,2021-03-31 00:00:00,Quest Diagnostics,DGX,,643000000,469000000,397000000,1105000000,681000000,681000000,-38000000,153000000,2720000000,2039000000,1615000000,-38000000,490000000,468000000
1551,2020-12-31 00:00:00,Quest Diagnostics,DGX,,800000000,579000000,436000000,1294000000,835000000,835000000,-40000000,191000000,3002000000,2167000000,1708000000,-35000000,609000000,576000000
1552,2021-09-25 00:00:00,Ralph Lauren Corporation,RL,,238100000,193300000,755100000,1011700000,251500000,251500000,-13600000,44800000,1504100000,1252600000,492400000,-13400000,193300000,193300000
1553,2021-06-26 00:00:00,Ralph Lauren Corporation,RL,,210000000,164700000,677400000,960100000,230200000,230200000,-13300000,45300000,1376300000,1146100000,416200000,-20200000,164700000,164700000
1554,2021-03-27 00:00:00,Ralph Lauren Corporation,RL,,-35300000,-74100000,901700000,809300000,41000000,41000000,-13900000,38800000,1287000000,1246000000,477700000,-76300000,-74100000,-74100000
1555,2020-12-26 00:00:00,Ralph Lauren Corporation,RL,,162200000,119800000,687300000,937400000,188900000,188900000,-12200000,42400000,1432800000,1243900000,495400000,-26700000,119800000,119800000
1556,2021-09-30 00:00:00,Raymond James Financial,RJF,,560000000,429000000,1902000000,2539000000,0,565000000,,131000000,2690000000,2125000000,151000000,-5000000,429000000,429000000
1557,2021-06-30 00:00:00,Raymond James Financial,RJF,,385000000,307000000,1776000000,2356000000,0,489000000,,78000000,2499000000,2010000000,143000000,-104000000,307000000,307000000
1558,2021-03-31 00:00:00,Raymond James Financial,RJF,,447000000,355000000,1750000000,2270000000,0,451000000,,92000000,2408000000,1957000000,138000000,-4000000,355000000,355000000
1559,2020-12-31 00:00:00,Raymond James Financial,RJF,,399000000,312000000,1610000000,2107000000,0,437000000,,87000000,2234000000,1797000000,127000000,-38000000,312000000,311000000
1560,2021-09-30 00:00:00,Raytheon Technologies,RTX,676000000,1476000000,1393000000,723000000,3128000000,1854000000,1854000000,-358000000,3000000,16213000000,14359000000,13085000000,-378000000,1473000000,1393000000
1561,2021-06-30 00:00:00,Raytheon Technologies,RTX,657000000,1430000000,1032000000,823000000,3226000000,1828000000,1828000000,-346000000,342000000,15880000000,14052000000,12654000000,-398000000,1088000000,1032000000
1562,2021-03-31 00:00:00,Raytheon Technologies,RTX,589000000,1158000000,753000000,689000000,2734000000,1543000000,1543000000,-357000000,345000000,15251000000,13708000000,12517000000,-385000000,813000000,753000000
1563,2020-12-31 00:00:00,Raytheon Technologies,RTX,710000000,37000000,135000000,1065000000,2309000000,557000000,557000000,-367000000,-178000000,16419000000,15862000000,14110000000,-520000000,215000000,135000000
1564,2021-09-30 00:00:00,Realty Income Corporation,O,,141355000,134996000,23813000,462213000,239568000,239568000,-76156000,6079000,491875000,252307000,29662000,-98213000,135276000,134996000
1565,2021-06-30 00:00:00,Realty Income Corporation,O,,133993000,124479000,21849000,432548000,222910000,222910000,-73674000,9225000,464282000,241372000,31734000,-88917000,124768000,124479000
1566,2021-03-31 00:00:00,Realty Income Corporation,O,,102461000,95940000,20796000,414305000,215524000,215524000,-73075000,6225000,442804000,227280000,28499000,-113063000,96236000,95940000
1567,2020-12-31 00:00:00,Realty Income Corporation,O,,122650000,117931000,16674000,390941000,199226000,199226000,-78764000,4500000,418076000,218850000,27135000,-76576000,118150000,117931000
1568,2021-09-30 00:00:00,Regency Centers,REG,,118848000,117406000,17789000,242371000,148311000,148311000,-36148000,0,321618000,173307000,79247000,-29463000,118848000,117406000
1569,2021-06-30 00:00:00,Regency Centers,REG,,96832000,95490000,19187000,205581000,111000000,111000000,-35962000,0,287594000,176594000,82013000,-14168000,96832000,95490000
1570,2021-03-31 00:00:00,Regency Centers,REG,,81625000,80656000,21287000,204621000,105377000,105377000,-37094000,0,286369000,180992000,81748000,-23752000,81625000,80656000
1571,2020-12-31 00:00:00,Regency Centers,REG,,38861000,38487000,20512000,187145000,71922000,71922000,-38301000,-355000,267858000,195936000,80713000,-33061000,39216000,38487000
1572,2021-09-30 00:00:00,Regeneron Pharmaceuticals,REGN,,1816600000,1632200000,445000000,2334200000,1847200000,1847200000,-14200000,184400000,3452800000,1605600000,1118600000,-30600000,1632200000,1632200000
1573,2021-06-30 00:00:00,Regeneron Pharmaceuticals,REGN,,3752800000,3098900000,414700000,3730600000,3347200000,3347200000,-14400000,653900000,5138500000,1791300000,1407900000,405600000,3098900000,3098900000
1574,2021-03-31 00:00:00,Regeneron Pharmaceuticals,REGN,,1253000000,1115200000,405600000,1477800000,1112700000,1112700000,-14600000,137800000,2528700000,1416000000,1050900000,140300000,1115200000,1115200000
1575,2020-12-31 00:00:00,Regeneron Pharmaceuticals,REGN,,1224600000,1149200000,398500000,1138600000,885300000,885300000,-14800000,75400000,2236200000,1350900000,1097600000,339300000,1149200000,1149200000
1576,2021-09-30 00:00:00,Regions Financial Corporation,RF,,831000000,651000000,740000000,1767000000,0,849000000,,180000000,1767000000,918000000,0,-18000000,651000000,624000000
1577,2021-06-30 00:00:00,Regions Financial Corporation,RF,,1021000000,790000000,723000000,1919000000,0,1023000000,,231000000,1919000000,896000000,0,-2000000,790000000,748000000
1578,2021-03-31 00:00:00,Regions Financial Corporation,RF,,822000000,642000000,732000000,1750000000,0,830000000,,180000000,1750000000,920000000,0,-8000000,642000000,614000000
1579,2020-12-31 00:00:00,Regions Financial Corporation,RF,,737000000,616000000,749000000,1722000000,0,782000000,,121000000,1722000000,940000000,0,-45000000,616000000,588000000
1580,2021-09-30 00:00:00,Republic Services,RSG,,470700000,350300000,299000000,1189900000,568800000,568800000,-78100000,119900000,2933900000,2365100000,1744000000,-98100000,350800000,350300000
1581,2021-06-30 00:00:00,Republic Services,RSG,,427400000,331100000,299500000,1162100000,538900000,538900000,-78400000,95400000,2812800000,2273900000,1650700000,-111500000,332000000,331100000
1582,2021-03-31 00:00:00,Republic Services,RSG,,400100000,295900000,265400000,1062100000,494100000,494100000,-78400000,103700000,2596400000,2102300000,1534300000,-94000000,296400000,295900000
1583,2020-12-31 00:00:00,Republic Services,RSG,,201300000,235400000,343700000,1112000000,480300000,480300000,-70600000,-35000000,2573200000,2092900000,1461200000,-279000000,236300000,235400000
1584,2021-09-30 00:00:00,ResMed,RMD,59950000,258788000,203613000,176719000,517348000,261913000,261913000,-5360000,55175000,904015000,642102000,386667000,-3125000,203613000,203613000
1585,2021-06-30 00:00:00,ResMed,RMD,59875000,239211000,195100000,181483000,501758000,241638000,241638000,-5345000,44111000,876103000,634465000,374345000,-2427000,195100000,195100000
1586,2021-03-31 00:00:00,ResMed,RMD,55941000,218005000,-78481000,160446000,458182000,223426000,223426000,-5878000,296486000,768767000,545341000,310585000,-5421000,-78481000,-78481000
1587,2020-12-31 00:00:00,ResMed,RMD,54935000,210592000,179514000,169470000,478879000,235621000,235621000,-5924000,31078000,800011000,564390000,321132000,-25029000,179514000,179514000
1588,2021-09-30 00:00:00,Robert Half International,RHI,,227658000,170871000,495576000,725327000,229179000,229179000,,56787000,1712566000,1483387000,987239000,-1521000,170871000,170871000
1589,2021-06-30 00:00:00,Robert Half International,RHI,,203862000,149213000,488093000,664872000,176203000,176203000,-151000,54649000,1580581000,1404378000,915709000,27659000,149213000,149213000
1590,2021-03-31 00:00:00,Robert Half International,RHI,,150106000,110598000,423062000,561711000,138073000,138073000,-151000,39508000,1398380000,1260307000,836669000,12033000,110598000,110598000
1591,2020-12-31 00:00:00,Robert Half International,RHI,,129585000,94416000,425162000,514327000,88948000,88948000,-151000,35169000,1304086000,1215138000,789759000,40637000,94416000,94416000
1592,2021-09-30 00:00:00,Rockwell Automation,ROK,,4300000,78500000,462700000,719400000,256700000,256700000,-26300000,-70300000,1807800000,1551100000,1088400000,-252400000,74600000,78500000
1593,2021-06-30 00:00:00,Rockwell Automation,ROK,,313500000,271300000,471600000,764400000,292800000,292800000,-22400000,44500000,1848200000,1555400000,1083800000,20700000,269000000,270900000
1594,2021-03-31 00:00:00,Rockwell Automation,ROK,,507700000,415000000,428800000,767400000,338600000,338600000,-23300000,97400000,1776100000,1437500000,1008700000,169100000,410300000,414100000
1595,2020-12-31 00:00:00,Rockwell Automation,ROK,,700700000,593300000,382000000,646500000,264500000,264500000,-22600000,110300000,1565300000,1300800000,918800000,436200000,590400000,592600000
1596,2021-09-30 00:00:00,Rollins,ROL,,127072000,93853000,194261000,344725000,126847000,126847000,-222000,33219000,650199000,523352000,305474000,225000,93853000,93853000
1597,2021-06-30 00:00:00,Rollins,ROL,,133939000,98854000,183482000,340342000,133554000,133554000,-506000,35085000,638204000,504650000,297862000,385000,98854000,98854000
1598,2021-03-31 00:00:00,Rollins,ROL,,119852000,92643000,162208000,274002000,88198000,88198000,-606000,27209000,535554000,447356000,261552000,31654000,92643000,92643000
1599,2020-12-31 00:00:00,Rollins,ROL,,86898000,62619000,159086000,269948000,88459000,88459000,-591000,24279000,536292000,447833000,266344000,-1561000,62619000,62619000
1600,2021-09-30 00:00:00,Roper Technologies,ROP,,343600000,289500000,592600000,996100000,403500000,403500000,-58200000,83800000,1462800000,1059300000,466700000,-59900000,259800000,289500000
1601,2021-06-30 00:00:00,Roper Technologies,ROP,,343600000,0,592600000,0,0,403500000,-58200000,0,0,0,0,0,259800000,289500000
1602,2021-03-31 00:00:00,Roper Technologies,ROP,,366900000,289000000,593300000,993800000,400500000,400500000,-60600000,77900000,1528600000,1128100000,534800000,-33600000,289000000,289000000
1603,2020-12-31 00:00:00,Roper Technologies,ROP,446100000,317500000,255800000,153400000,966600000,367100000,367100000,-63700000,61700000,1505300000,1138200000,538700000,-49600000,255800000,255800000
1604,2021-07-31 00:00:00,Ross Stores,ROST,,657608000,494258000,717788000,1394103000,676315000,676315000,-18906000,163350000,4804974000,4128659000,3410871000,-18707000,494258000,494258000
1605,2021-05-01 00:00:00,Ross Stores,ROST,,623582000,476479000,675053000,1317684000,642631000,642631000,-19285000,147103000,4516080000,3873449000,3198396000,-19049000,476479000,476479000
1606,2021-01-30 00:00:00,Ross Stores,ROST,,382851000,237980000,1291999000,1934002000,642003000,642003000,-19380000,144871000,4249671000,3607668000,2315669000,-259152000,237980000,237980000
1607,2020-10-31 00:00:00,Ross Stores,ROST,,136493000,131197000,877857000,1043090000,165233000,165233000,-29070000,5296000,3754509000,3589276000,2711419000,-28740000,131197000,131197000
1608,2021-09-30 00:00:00,Royal Caribbean Group,RCL,,-1424554000,-1424554000,330472000,-349683000,-1006062000,-1006062000,-430661000,0,456958000,1463020000,806641000,-418492000,-1424554000,-1424554000
1609,2021-06-30 00:00:00,Royal Caribbean Group,RCL,,-1347255000,-1347255000,290369000,-369105000,-982913000,-982913000,-304811000,0,50914000,1033827000,420019000,-364342000,-1347255000,-1347255000
1610,2021-03-31 00:00:00,Royal Caribbean Group,RCL,,-1131722000,-1131722000,263171000,-236343000,-809680000,-809680000,-272514000,0,42014000,851694000,278357000,-322042000,-1131722000,-1131722000
1611,2020-12-31 00:00:00,Royal Caribbean Group,RCL,,-1381935000,-1366935000,251349000,-235306000,-804683000,-804683000,-273089000,-15000000,34138000,838821000,269444000,-577252000,-1366935000,-1366935000
1612,2021-09-30 00:00:00,S&P Global,SPGI,,1074000000,797000000,358000000,1544000000,1145000000,1145000000,-31000000,213000000,2087000000,942000000,543000000,-71000000,861000000,797000000
1613,2021-06-30 00:00:00,S&P Global,SPGI,,1144000000,798000000,310000000,1573000000,1218000000,1218000000,-32000000,287000000,2106000000,888000000,533000000,-74000000,857000000,798000000
1614,2021-03-31 00:00:00,S&P Global,SPGI,,1056000000,755000000,298000000,1489000000,1141000000,1141000000,-32000000,248000000,2016000000,875000000,527000000,-85000000,808000000,755000000
1615,2020-12-31 00:00:00,S&P Global,SPGI,,640000000,454000000,384000000,1308000000,872000000,872000000,-32000000,135000000,1867000000,995000000,559000000,-232000000,505000000,454000000
1616,2021-07-31 00:00:00,Salesforce,CRM,1020000000,826000000,535000000,3321000000,4727000000,386000000,386000000,-41000000,291000000,6340000000,5954000000,1613000000,440000000,535000000,535000000
1617,2021-04-30 00:00:00,Salesforce,CRM,951000000,604000000,469000000,3103000000,4408000000,354000000,354000000,-34000000,135000000,5963000000,5609000000,1555000000,250000000,469000000,469000000
1618,2021-01-31 00:00:00,Salesforce,CRM,939000000,425000000,267000000,3206000000,4338000000,193000000,193000000,-102000000,158000000,5817000000,5624000000,1479000000,232000000,267000000,267000000
1619,2020-10-31 00:00:00,Salesforce,CRM,902000000,1250000000,1081000000,2899000000,4025000000,224000000,224000000,-29000000,169000000,5419000000,5195000000,1394000000,1026000000,1081000000,1081000000
1620,2021-09-30 00:00:00,SBA Communications,SBAC,,36964000,47798000,50771000,443552000,221229000,221229000,-105953000,-10834000,589305000,368076000,145753000,-184265000,47798000,47798000
1621,2021-06-30 00:00:00,SBA Communications,SBAC,,199919000,152669000,53710000,432975000,203239000,203239000,-107221000,47250000,575528000,372289000,142553000,-3320000,152669000,152669000
1622,2021-03-31 00:00:00,SBA Communications,SBAC,,-32667000,-11745000,51381000,413964000,178062000,178062000,-106790000,-20922000,548739000,370677000,134775000,-210729000,-11745000,-11745000
1623,2020-12-31 00:00:00,SBA Communications,SBAC,,140533000,105782000,47192000,403891000,175920000,175920000,-103196000,34347000,535907000,359987000,132016000,-35387000,106186000,105782000
1624,2021-09-30 00:00:00,Schlumberger,SLB,140000000,691000000,550000000,80000000,985000000,765000000,765000000,-130000000,129000000,5847000000,5082000000,4862000000,-74000000,562000000,550000000
1625,2021-06-30 00:00:00,Schlumberger,SLB,134000000,542000000,431000000,70000000,866000000,662000000,662000000,-136000000,99000000,5634000000,4972000000,4768000000,-120000000,443000000,431000000
1626,2021-03-31 00:00:00,Schlumberger,SLB,135000000,386000000,299000000,81000000,719000000,503000000,503000000,-136000000,74000000,5223000000,4720000000,4504000000,-117000000,312000000,299000000
1627,2020-12-31 00:00:00,Schlumberger,SLB,128000000,471000000,374000000,72000000,704000000,504000000,504000000,-144000000,89000000,5532000000,5028000000,4828000000,-33000000,382000000,374000000
1628,2021-10-01 00:00:00,Seagate Technology,STX,233000000,533000000,526000000,133000000,956000000,587000000,587000000,-59000000,7000000,3115000000,2528000000,2159000000,-54000000,526000000,526000000
1629,2021-07-02 00:00:00,Seagate Technology,STX,232000000,497000000,482000000,136000000,885000000,514000000,514000000,-59000000,15000000,3013000000,2499000000,2128000000,-17000000,482000000,482000000
1630,2021-04-02 00:00:00,Seagate Technology,STX,227000000,339000000,329000000,126000000,740000000,384000000,384000000,-59000000,10000000,2731000000,2347000000,1991000000,-45000000,329000000,329000000
1631,2021-01-01 00:00:00,Seagate Technology,STX,221000000,291000000,280000000,122000000,696000000,350000000,350000000,-52000000,11000000,2623000000,2273000000,1927000000,-59000000,280000000,280000000
1632,2021-09-30 00:00:00,Sealed Air,SEE,,154400000,107700000,189600000,403700000,204400000,204400000,-44400000,46600000,1406700000,1202300000,1003000000,-50000000,107800000,107700000
1633,2021-06-30 00:00:00,Sealed Air,SEE,,154400000,108100000,190600000,400700000,200400000,200400000,-44100000,45800000,1328500000,1128100000,927800000,-46000000,108600000,108100000
1634,2021-03-31 00:00:00,Sealed Air,SEE,,160400000,110100000,187700000,401100000,203700000,203700000,-45100000,54600000,1267100000,1063400000,866000000,-43300000,105800000,110100000
1635,2020-12-31 00:00:00,Sealed Air,SEE,,184900000,142200000,195000000,424400000,219900000,219900000,-46100000,47400000,1340900000,1121000000,916500000,-35000000,137500000,142100000
1636,2021-09-30 00:00:00,Sempra Energy,SRE,,-974000000,-637000000,66000000,975000000,438000000,438000000,-259000000,-342000000,3013000000,2575000000,2038000000,-1412000000,-632000000,-648000000
1637,2021-06-30 00:00:00,Sempra Energy,SRE,,593000000,444000000,15000000,915000000,437000000,437000000,-259000000,139000000,2741000000,2304000000,1826000000,156000000,454000000,424000000
1638,2021-03-31 00:00:00,Sempra Energy,SRE,,1086000000,895000000,-29000000,1415000000,1002000000,1002000000,-259000000,158000000,3259000000,2257000000,1844000000,84000000,928000000,874000000
1639,2020-12-31 00:00:00,Sempra Energy,SRE,,621000000,461000000,57000000,1163000000,682000000,682000000,-263000000,189000000,3171000000,2489000000,2008000000,-61000000,432000000,414000000
1640,2021-09-30 00:00:00,ServiceNow,NOW,358000000,68000000,63000000,730000000,1162000000,74000000,74000000,-7000000,5000000,1512000000,1438000000,350000000,-6000000,63000000,63000000
1641,2021-06-30 00:00:00,ServiceNow,NOW,333000000,50000000,59000000,696000000,1080000000,51000000,51000000,-7000000,-9000000,1409000000,1358000000,329000000,-1000000,59000000,59000000
1642,2021-03-31 00:00:00,ServiceNow,NOW,314000000,99000000,82000000,650000000,1061000000,97000000,97000000,-7000000,17000000,1360000000,1263000000,299000000,2000000,82000000,82000000
1643,2020-12-31 00:00:00,ServiceNow,NOW,284297000,13360000,16648000,668999000,971226000,17930000,17930000,-7708000,-3288000,1250330000,1232400000,279104000,-4570000,16648000,16648000
1644,2021-09-30 00:00:00,Sherwin-Williams,SHW,,611500000,502200000,1370000000,2139600000,692900000,692900000,-83100000,109300000,5146700000,4453800000,3007100000,-81400000,502200000,502200000
1645,2021-06-30 00:00:00,Sherwin-Williams,SHW,,819200000,648600000,1438900000,2411400000,892200000,892200000,-83500000,170600000,5379800000,4487600000,2968400000,-73000000,648600000,648600000
1646,2021-03-31 00:00:00,Sherwin-Williams,SHW,,509000000,409600000,1326800000,2112000000,703500000,703500000,-83200000,99400000,4656000000,3952500000,2544000000,-194500000,409600000,409600000
1647,2020-12-31 00:00:00,Sherwin-Williams,SHW,,503900000,407000000,1465000000,2128700000,568200000,568200000,-82800000,96900000,4488800000,3920600000,2360100000,-64300000,407000000,407000000
1648,2021-09-30 00:00:00,Simon Property Group,SPG,,845910000,680770000,94211000,1049169000,612324000,612324000,-199772000,67262000,1296554000,684230000,247385000,233586000,778648000,679936000
1649,2021-06-30 00:00:00,Simon Property Group,SPG,,752872000,618091000,74518000,1024342000,604723000,604723000,-200419000,47003000,1254146000,649423000,229804000,148149000,705869000,617257000
1650,2021-03-31 00:00:00,Simon Property Group,SPG,,504562000,446694000,72061000,1015965000,604612000,604612000,-202016000,-5898000,1239951000,635339000,223986000,-100050000,510460000,445860000
1651,2020-12-31 00:00:00,Simon Property Group,SPG,,311154000,272317000,84260000,917450000,463187000,463187000,-197855000,-1572000,1132568000,669381000,215118000,-152033000,312726000,271483000
1652,2021-10-01 00:00:00,Skyworks Solutions,SWKS,149200000,316200000,326300000,100500000,613700000,335900000,335900000,-10800000,-10100000,1310900000,975000000,697200000,-19700000,326300000,326300000
1653,2021-07-02 00:00:00,Skyworks Solutions,SWKS,130800000,336200000,337800000,85100000,558600000,340300000,340300000,-2600000,-1600000,1116400000,776100000,557800000,-4100000,337800000,337800000
1654,2021-04-02 00:00:00,Skyworks Solutions,SWKS,130700000,375500000,325000000,70200000,578400000,374700000,374700000,-2600000,50500000,1171800000,797100000,593400000,800000,325000000,325000000
1655,2021-01-01 00:00:00,Skyworks Solutions,SWKS,121600000,570900000,509300000,66600000,761700000,570700000,570700000,-2600000,61600000,1510000000,939300000,748300000,200000,509300000,509300000
1656,2021-10-02 00:00:00,Snap-on,SNA,,262400000,196200000,315600000,591300000,275700000,275700000,-13200000,60900000,1125000000,849300000,533700000,-13300000,201500000,196200000
1657,2021-07-03 00:00:00,Snap-on,SNA,,276100000,208000000,322200000,611900000,289700000,289700000,-14200000,62900000,1168300000,878600000,556400000,-13600000,213200000,208000000
1658,2021-04-03 00:00:00,Snap-on,SNA,,256700000,192600000,308900000,578900000,270000000,270000000,-14300000,59100000,1113200000,843200000,534300000,-13300000,197600000,192600000
1659,2021-01-02 00:00:00,Snap-on,SNA,,272000000,208900000,294500000,585700000,291200000,291200000,-15300000,58200000,1167800000,876600000,582100000,-19200000,213800000,208900000
1660,2021-09-30 00:00:00,Southern Company,SO,,1478000000,1101000000,-142000000,3070000000,1740000000,1740000000,-455000000,372000000,6238000000,4498000000,3168000000,-262000000,1106000000,1101000000
1661,2021-06-30 00:00:00,Southern Company,SO,,360000000,372000000,-142000000,2361000000,839000000,839000000,-454000000,-12000000,5198000000,4359000000,2837000000,-479000000,372000000,372000000
1662,2021-03-31 00:00:00,Southern Company,SO,,1293000000,1135000000,-143000000,2818000000,1745000000,1745000000,-454000000,190000000,5910000000,4165000000,3092000000,-452000000,1103000000,1135000000
1663,2020-12-31 00:00:00,Southern Company,SO,,303000000,387000000,-104000000,2080000000,807000000,807000000,-482000000,-50000000,5117000000,4310000000,3037000000,-504000000,353000000,387000000
1664,2021-09-30 00:00:00,Southwest Airlines,LUV,,600000000,446000000,,872000000,-59000000,-59000000,-106000000,154000000,4679000000,4738000000,3807000000,659000000,446000000,446000000
1665,2021-06-30 00:00:00,Southwest Airlines,LUV,,502000000,348000000,,688000000,-161000000,-161000000,-108000000,154000000,4008000000,4169000000,3320000000,663000000,348000000,348000000
1666,2021-03-31 00:00:00,Southwest Airlines,LUV,,146000000,116000000,,-544000000,-1268000000,-1268000000,-103000000,30000000,2052000000,3320000000,2596000000,1414000000,116000000,116000000
1667,2020-12-31 00:00:00,Southwest Airlines,LUV,,-1331000000,-908000000,168000000,-601000000,-1200000000,-1200000000,-102000000,-423000000,2013000000,3213000000,2614000000,-131000000,-908000000,-908000000
1668,2021-07-03 00:00:00,Stanley Black & Decker,SWK,,532200000,459500000,878900000,1545700000,621100000,621100000,-46500000,73700000,4300900000,3679800000,2755200000,-88900000,458500000,454700000
1669,2021-04-03 00:00:00,Stanley Black & Decker,SWK,,606300000,487400000,827400000,1569500000,749200000,749200000,-47500000,119500000,4197100000,3447900000,2627600000,-142900000,486800000,478000000
1670,2021-01-02 00:00:00,Stanley Black & Decker,SWK,,535100000,467300000,835300000,1568300000,753100000,753100000,-53400000,67400000,4407600000,3654500000,2839300000,-218000000,467700000,458000000
1671,2020-09-26 00:00:00,Stanley Black & Decker,SWK,,473600000,394900000,695300000,1383300000,614300000,614300000,-52700000,78400000,3850200000,3235900000,2466900000,-140700000,395200000,385500000
1672,2021-06-27 00:00:00,Starbucks,SBUX,,1411300000,1153400000,494900000,2323600000,1403000000,1403000000,-113400000,257100000,7496500000,6093500000,5172900000,8300000,1154200000,1153400000
1673,2021-03-28 00:00:00,Starbucks,SBUX,,889900000,659400000,464400000,1852300000,933500000,933500000,-118600000,230500000,6668000000,5734500000,4815700000,-43600000,659400000,659400000
1674,2020-12-27 00:00:00,Starbucks,SBUX,,808300000,622200000,472100000,1833000000,903000000,903000000,-120700000,186100000,6749400000,5846400000,4916400000,-94700000,622200000,622200000
1675,2020-09-27 00:00:00,Starbucks,SBUX,,442400000,392600000,439000000,1625100000,723100000,723100000,-124900000,49700000,6203100000,5480000000,4578000000,-280700000,392700000,392600000
1676,2021-06-30 00:00:00,State Street Corporation,STT,,938000000,763000000,1591000000,3049000000,0,1012000000,,175000000,3049000000,2037000000,0,-74000000,763000000,728000000
1677,2021-03-31 00:00:00,State Street Corporation,STT,,627000000,519000000,1789000000,2959000000,0,695000000,,108000000,2959000000,2264000000,0,-68000000,519000000,489000000
1678,2020-12-31 00:00:00,State Street Corporation,STT,,641000000,537000000,1579000000,2917000000,0,845000000,,104000000,2917000000,2072000000,0,-204000000,537000000,498000000
1679,2020-09-30 00:00:00,State Street Corporation,STT,,681000000,555000000,1586000000,2784000000,0,755000000,,126000000,2784000000,2029000000,0,-74000000,555000000,517000000
1680,2021-06-30 00:00:00,Steris,STE,18192000,-28977000,-21807000,252756000,426282000,155334000,155334000,-21812000,-7075000,968422000,813088000,542140000,-184311000,-21902000,-21807000
1681,2021-03-31 00:00:00,Steris,STE,17514000,137519000,88851000,199420000,386852000,169918000,169918000,-10124000,49369000,873531000,703613000,486679000,-32399000,88150000,88851000
1682,2020-12-31 00:00:00,Steris,STE,16438000,139430000,114501000,170810000,353112000,165864000,165864000,-8899000,24842000,808924000,643060000,455812000,-26434000,114588000,114501000
1683,2020-09-30 00:00:00,Steris,STE,16143000,133786000,105858000,171572000,334576000,146861000,146861000,-8665000,27778000,756132000,609271000,421556000,-13075000,106008000,105858000
1684,2021-06-30 00:00:00,Stryker Corporation,SYK,310000000,662000000,592000000,1505000000,2772000000,808000000,808000000,,70000000,4294000000,3486000000,1522000000,-146000000,592000000,592000000
1685,2021-03-31 00:00:00,Stryker Corporation,SYK,288000000,367000000,302000000,1394000000,2586000000,723000000,723000000,,65000000,3953000000,3230000000,1367000000,-356000000,302000000,302000000
1686,2020-12-31 00:00:00,Stryker Corporation,SYK,255000000,671000000,568000000,1284000000,2773000000,1104000000,1104000000,-399000000,103000000,4262000000,3158000000,1489000000,-433000000,568000000,568000000
1687,2020-09-30 00:00:00,Stryker Corporation,SYK,242000000,780000000,621000000,1188000000,2461000000,917000000,917000000,-399000000,159000000,3737000000,2820000000,1276000000,-137000000,621000000,621000000
1688,2021-03-31 00:00:00,SVB Financial,SIVB,,749079000,536814000,581082000,1385080000,0,758542000,,187315000,1385080000,626538000,0,-9463000,561764000,532220000
1689,2020-12-31 00:00:00,SVB Financial,SIVB,,586897000,392910000,554026000,1251696000,0,625398000,,148096000,1251696000,626298000,0,-38501000,438801000,388316000
1690,2020-09-30 00:00:00,SVB Financial,SIVB,,636320000,446307000,446535000,1097323000,0,613235000,,162265000,1097323000,484088000,0,23085000,474055000,441713000
1691,2020-06-30 00:00:00,SVB Financial,SIVB,,335658000,233529000,433170000,815294000,0,342477000,,87869000,815294000,472817000,0,-6819000,247789000,228935000
1692,2021-06-30 00:00:00,Synchrony Financial,SYF,,1641000000,1242000000,799000000,2589000000,0,1641000000,,399000000,2589000000,948000000,0,0,1242000000,1232000000
1693,2021-03-31 00:00:00,Synchrony Financial,SYF,,1315000000,1025000000,780000000,2247000000,0,1315000000,,290000000,2247000000,932000000,0,0,1025000000,1014000000
1694,2020-12-31 00:00:00,Synchrony Financial,SYF,,944000000,738000000,803000000,1944000000,0,1321000000,,206000000,1944000000,623000000,0,-377000000,738000000,728000000
1695,2020-09-30 00:00:00,Synchrony Financial,SYF,,412000000,313000000,757000000,1479000000,0,456000000,,99000000,1479000000,1023000000,0,-44000000,313000000,303000000
1696,2021-07-31 00:00:00,Synopsys,SNPS,371146000,213337000,198646000,255274000,863934000,217074000,217074000,-757000,14945000,1057130000,840056000,193196000,-3737000,198392000,198646000
1697,2021-04-30 00:00:00,Synopsys,SNPS,362345000,215995000,195078000,245448000,821745000,194231000,194231000,-807000,21193000,1024323000,830092000,202578000,21764000,194802000,195078000
1698,2021-01-31 00:00:00,Synopsys,SNPS,357468000,177104000,162345000,248116000,774208000,148348000,148348000,-739000,15076000,970321000,821973000,196113000,28756000,162028000,162345000
1699,2020-10-31 00:00:00,Synopsys,SNPS,339566000,191566000,197455000,256295000,812610000,195745000,195745000,-750000,-4989000,1025439000,829694000,212829000,-4179000,196555000,197455000
1700,2021-03-27 00:00:00,Sysco,SYY,,102852000,88927000,1908018000,2122668000,226793000,226793000,-145773000,13925000,11824589000,11597796000,9701921000,-123941000,88927000,88927000
1701,2020-12-26 00:00:00,Sysco,SYY,,81120000,67289000,1923229000,2098458000,175229000,175229000,-146498000,13831000,11558982000,11383753000,9460524000,-94109000,67289000,67289000
1702,2020-09-26 00:00:00,Sysco,SYY,,258738000,216900000,1784838000,2219845000,435007000,435007000,-146717000,41838000,11777379000,11342372000,9557534000,-176269000,216900000,216900000
1703,2020-06-27 00:00:00,Sysco,SYY,,-736245000,-618419000,1589107000,1565655000,-34124000,-34124000,-164269000,-117826000,8866564000,8900688000,7300909000,-702121000,-618419000,-618419000
1704,2021-06-30 00:00:00,T-Mobile US,TMUS,,1255000000,978000000,4572000000,11366000000,2717000000,2717000000,-852000000,277000000,19950000000,17233000000,8584000000,-1462000000,978000000,978000000
1705,2021-03-31 00:00:00,T-Mobile US,TMUS,,1179000000,933000000,4660000000,11386000000,2437000000,2437000000,-838000000,246000000,19759000000,17322000000,8373000000,-1258000000,933000000,933000000
1706,2020-12-31 00:00:00,T-Mobile US,TMUS,,821000000,750000000,4607000000,11222000000,2396000000,2396000000,-798000000,71000000,20341000000,17945000000,9119000000,-1575000000,750000000,750000000
1707,2020-09-30 00:00:00,T-Mobile US,TMUS,,1660000000,1253000000,4670000000,11670000000,2850000000,2850000000,-809000000,407000000,19272000000,16422000000,7602000000,-1190000000,1253000000,1253000000
1708,2021-06-30 00:00:00,T. Rowe Price,TROW,,1102000000,815700000,231400000,1189500000,958100000,958100000,,259300000,1929300000,971200000,739800000,143900000,842700000,793500000
1709,2021-03-31 00:00:00,T. Rowe Price,TROW,,995300000,749400000,223500000,1116700000,893200000,893200000,,230500000,1826800000,933600000,710100000,102100000,764800000,729500000
1710,2020-12-31 00:00:00,T. Rowe Price,TROW,,1146000000,783400000,221800000,977700000,755900000,755900000,,216400000,1732900000,977000000,755200000,390100000,929600000,762200000
1711,2020-09-30 00:00:00,T. Rowe Price,TROW,,920500000,643200000,204300000,933200000,728900000,728900000,,221900000,1595800000,866900000,662600000,191600000,698600000,625300000
1712,2021-09-30 00:00:00,Take-Two Interactive,TTWO,101508000,19974000,10297000,240401000,456794000,98704000,98704000,-113000,9677000,858198000,759494000,401404000,-78730000,10297000,10297000
1713,2021-06-30 00:00:00,Take-Two Interactive,TTWO,92294000,171444000,152256000,206298000,493402000,182345000,182345000,-145000,19188000,813346000,631001000,319944000,-10901000,152256000,152256000
1714,2021-03-31 00:00:00,Take-Two Interactive,TTWO,83559000,253591000,218812000,205062000,573630000,269529000,269529000,-5902000,34779000,839431000,569902000,265801000,-15938000,218812000,218812000
1715,2020-12-31 00:00:00,Take-Two Interactive,TTWO,86428000,216446000,182248000,238489000,520177000,181253000,181253000,-141000,34198000,860889000,679636000,340712000,35193000,182248000,182248000
1716,2021-07-03 00:00:00,Tapestry,TPR,,242200000,199800000,885500000,1158000000,272500000,272500000,-17100000,42400000,1615400000,1342900000,457400000,-30300000,199800000,199800000
1717,2021-03-27 00:00:00,Tapestry,TPR,,95400000,91700000,729000000,911900000,182900000,182900000,-17400000,3700000,1273300000,1090400000,361400000,-87500000,91700000,91700000
1718,2020-12-26 00:00:00,Tapestry,TPR,,374300000,311000000,762600000,1173700000,411100000,411100000,-19400000,63300000,1685400000,1274300000,511700000,-36800000,311000000,311000000
1719,2020-09-26 00:00:00,Tapestry,TPR,,185400000,231700000,601400000,830200000,228800000,228800000,-20200000,-46300000,1172200000,943400000,342000000,-43400000,231700000,231700000
1720,2021-07-31 00:00:00,Target Corporation,TGT,,2370000000,1817000000,4802000000,7880000000,2514000000,2514000000,-104000000,553000000,25160000000,22646000000,17280000000,-144000000,1817000000,1817000000
1721,2021-05-01 00:00:00,Target Corporation,TGT,,2609000000,2097000000,4462000000,7481000000,2421000000,2421000000,-108000000,512000000,24197000000,21776000000,16716000000,188000000,2097000000,2097000000
1722,2021-01-30 00:00:00,Target Corporation,TGT,,1730000000,1380000000,5446000000,7638000000,1622000000,1622000000,-106000000,350000000,28339000000,26717000000,20701000000,108000000,1380000000,1380000000
1723,2020-10-31 00:00:00,Target Corporation,TGT,,1298000000,1014000000,4644000000,7123000000,1938000000,1938000000,-120000000,284000000,22632000000,20694000000,15509000000,-640000000,1014000000,1014000000
1724,2021-06-25 00:00:00,TE Connectivity,TEL,168000000,705000000,580000000,362000000,1268000000,737000000,737000000,-14000000,124000000,3845000000,3108000000,2577000000,-32000000,581000000,580000000
1725,2021-03-26 00:00:00,TE Connectivity,TEL,174000000,611000000,506000000,397000000,1210000000,637000000,637000000,-13000000,106000000,3738000000,3101000000,2528000000,-26000000,505000000,506000000
1726,2020-12-25 00:00:00,TE Connectivity,TEL,162000000,435000000,381000000,358000000,1146000000,608000000,608000000,-15000000,60000000,3522000000,2914000000,2376000000,-173000000,375000000,381000000
1727,2020-09-25 00:00:00,TE Connectivity,TEL,148000000,337000000,230000000,352000000,969000000,469000000,469000000,-12000000,109000000,3261000000,2792000000,2292000000,-132000000,228000000,230000000
1728,2021-07-04 00:00:00,Teledyne Technologies,TDY,,92100000,64700000,223700000,481600000,225100000,225100000,-21200000,27400000,1121000000,895900000,639400000,-133000000,64700000,64700000
1729,2021-04-04 00:00:00,Teledyne Technologies,TDY,,101300000,84700000,168300000,313200000,144900000,144900000,-35700000,16600000,805700000,660800000,492500000,-43600000,84700000,84700000
1730,2021-01-03 00:00:00,Teledyne Technologies,TDY,,141100000,132100000,158200000,303100000,144900000,144900000,-3400000,9000000,809300000,664400000,506200000,-3800000,132100000,132100000
1731,2020-09-27 00:00:00,Teledyne Technologies,TDY,,119700000,93900000,164800000,290500000,125700000,125700000,-4100000,25800000,749000000,623300000,458500000,-6000000,93900000,93900000
1732,2021-06-27 00:00:00,Teleflex,TFX,33283000,99695000,83248000,224159000,397556000,140114000,140114000,-16171000,16412000,713473000,573359000,315917000,-40419000,83283000,83248000
1733,2021-03-28 00:00:00,Teleflex,TFX,29947000,87295000,74866000,196794000,344527000,117786000,117786000,-16798000,12428000,633925000,516139000,289398000,-30491000,74867000,74866000
1734,2020-12-31 00:00:00,Teleflex,TFX,33769000,76561000,76131000,209885000,383554000,139900000,139900000,-18721000,-40000,711179000,571279000,327625000,-63339000,76601000,76131000
1735,2020-09-27 00:00:00,Teleflex,TFX,29218000,115654000,116587000,171673000,329324000,128433000,128433000,-16652000,-951000,628301000,499868000,298977000,-12779000,116605000,116587000
1736,2021-07-04 00:00:00,Teradyne,TER,110021000,384026000,328319000,140187000,646989000,389272000,389272000,-5566000,55707000,1085728000,696456000,438739000,-5246000,328319000,328319000
1737,2021-04-04 00:00:00,Teradyne,TER,100402000,223993000,205512000,129797000,461618000,225473000,225473000,-6004000,18481000,781606000,556133000,319988000,-1480000,205512000,205512000
1738,2020-12-31 00:00:00,Teradyne,TER,100794000,222926000,196332000,135525000,449790000,207212000,207212000,-6351000,26594000,758969000,551757000,309179000,15714000,196332000,196332000
1739,2020-09-27 00:00:00,Teradyne,TER,94909000,263731000,222718000,115840000,458928000,241869000,241869000,-6237000,41013000,819484000,577615000,360556000,21862000,222718000,222718000
1740,2021-03-31 00:00:00,Tesla,TSLA,666000000,533000000,438000000,1056000000,2215000000,493000000,493000000,-79000000,69000000,10389000000,9896000000,8174000000,40000000,464000000,438000000
1741,2020-12-31 00:00:00,Tesla,TSLA,522000000,379000000,270000000,969000000,2066000000,575000000,575000000,-241000000,83000000,10744000000,10169000000,8678000000,-196000000,296000000,270000000
1742,2020-09-30 00:00:00,Tesla,TSLA,366000000,555000000,331000000,931000000,2063000000,766000000,766000000,-162000000,186000000,8771000000,8005000000,6708000000,-211000000,369000000,300000000
1743,2020-06-30 00:00:00,Tesla,TSLA,279000000,150000000,104000000,661000000,1267000000,327000000,327000000,-173000000,21000000,6036000000,5709000000,4769000000,-177000000,129000000,104000000
1744,2021-06-30 00:00:00,Texas Instruments,TXN,391000000,2242000000,1931000000,435000000,3077000000,2203000000,2203000000,-44000000,311000000,4580000000,2377000000,1503000000,39000000,1931000000,1924000000
1745,2021-03-31 00:00:00,Texas Instruments,TXN,386000000,1939000000,1753000000,436000000,2797000000,1928000000,1928000000,-46000000,186000000,4289000000,2361000000,1492000000,11000000,1753000000,1745000000
1746,2020-12-31 00:00:00,Texas Instruments,TXN,388000000,1927000000,1688000000,364000000,2646000000,1847000000,1847000000,-48000000,239000000,4076000000,2229000000,1430000000,80000000,1688000000,1680000000
1747,2020-09-30 00:00:00,Texas Instruments,TXN,386000000,1587000000,1353000000,415000000,2453000000,1601000000,1601000000,-49000000,234000000,3817000000,2216000000,1364000000,-14000000,1353000000,1347000000
1748,2021-07-03 00:00:00,Textron,TXT,,218000000,183000000,275000000,527000000,252000000,252000000,-32000000,34000000,3191000000,2939000000,2664000000,-34000000,184000000,183000000
1749,2021-04-03 00:00:00,Textron,TXT,,190000000,171000000,258000000,474000000,216000000,216000000,-35000000,19000000,2879000000,2663000000,2405000000,-26000000,171000000,171000000
1750,2021-01-02 00:00:00,Textron,TXT,,215000000,236000000,264000000,538000000,274000000,274000000,-36000000,-21000000,3667000000,3393000000,3129000000,-59000000,236000000,236000000
1751,2020-10-03 00:00:00,Textron,TXT,,116000000,115000000,237000000,398000000,161000000,161000000,-38000000,1000000,2735000000,2574000000,2337000000,-45000000,115000000,115000000
1752,2021-07-31 00:00:00,The Cooper Companies,COO,24800000,94000000,615800000,293800000,516100000,159300000,159300000,-5600000,-521800000,763400000,604100000,247300000,-65300000,615800000,615800000
1753,2021-04-30 00:00:00,The Cooper Companies,COO,21000000,136400000,117500000,279100000,487100000,149900000,149900000,-6100000,18900000,719500000,569600000,232400000,-13500000,117500000,117500000
1754,2021-01-31 00:00:00,The Cooper Companies,COO,21400000,139500000,2101100000,257600000,450700000,137000000,137000000,-6400000,-1961600000,680500000,543500000,229800000,2500000,2101100000,2101100000
1755,2020-10-31 00:00:00,The Cooper Companies,COO,25500000,93700000,81200000,264200000,514100000,190200000,190200000,-6700000,12500000,681600000,491400000,167500000,-96500000,81200000,81200000
1756,2021-06-30 00:00:00,The Hartford,HIG,,1110000000,905000000,1202000000,2379000000,1169000000,1169000000,-47000000,205000000,5579000000,4410000000,3200000000,-59000000,905000000,900000000
1757,2021-03-31 00:00:00,The Hartford,HIG,,303000000,249000000,1144000000,1547000000,374000000,374000000,-47000000,54000000,5289000000,4915000000,3742000000,-71000000,249000000,244000000
1758,2020-12-31 00:00:00,The Hartford,HIG,,652000000,537000000,1087000000,1819000000,684000000,684000000,-47000000,115000000,5318000000,4634000000,3499000000,-32000000,537000000,532000000
1759,2020-09-30 00:00:00,The Hartford,HIG,,532000000,459000000,1079000000,1779000000,682000000,682000000,-49000000,73000000,5162000000,4480000000,3383000000,-150000000,459000000,453000000
1760,2021-07-04 00:00:00,The Hershey Company,HSY,,418416000,301230000,468647000,926487000,457840000,457840000,-31684000,117186000,1989422000,1531582000,1062935000,-39424000,301230000,301230000
1761,2021-04-04 00:00:00,The Hershey Company,HSY,,514194000,395799000,494183000,1052946000,558763000,558763000,-37046000,117323000,2295948000,1737185000,1243002000,-44569000,396871000,395799000
1762,2020-12-31 00:00:00,The Hershey Company,HSY,37577000,263400000,291387000,504428000,964280000,422275000,422275000,-38720000,-27930000,2185244000,1762969000,1220964000,-158875000,291330000,291387000
1763,2020-09-27 00:00:00,The Hershey Company,HSY,37577000,562508000,447283000,473395000,1080024000,606629000,606629000,-38056000,115250000,2219829000,1613200000,1139805000,-44121000,447258000,447283000
1764,2021-06-30 00:00:00,The Mosaic Company,MOS,,554700000,437200000,107600000,729300000,619100000,619100000,-43800000,115900000,2800700000,2181600000,2071400000,-64400000,438800000,437200000
1765,2021-03-31 00:00:00,The Mosaic Company,MOS,,217900000,156700000,101700000,464900000,358200000,358200000,-49400000,59700000,2297100000,1938900000,1832200000,-140300000,158200000,156700000
1766,2020-12-31 00:00:00,The Mosaic Company,MOS,,347400000,827900000,110900000,348400000,264100000,264100000,-55500000,-480900000,2457400000,2193300000,2109000000,83300000,828300000,827900000
1767,2020-09-30 00:00:00,The Mosaic Company,MOS,,33500000,-6200000,97600000,374100000,149500000,149500000,-50800000,38100000,2381500000,2232000000,2007400000,-116000000,-4600000,-6200000
1768,2021-06-30 00:00:00,The Travelers Companies,TRV,,1131000000,934000000,1174000000,2388000000,1214000000,1214000000,-83000000,197000000,8687000000,7473000000,6299000000,-83000000,934000000,927000000
1769,2021-03-31 00:00:00,The Travelers Companies,TRV,,891000000,733000000,1163000000,2136000000,973000000,973000000,-82000000,158000000,8313000000,7340000000,6177000000,-82000000,733000000,728000000
1770,2020-12-31 00:00:00,The Travelers Companies,TRV,,1616000000,1310000000,1142000000,2841000000,1699000000,1699000000,-83000000,306000000,8397000000,6698000000,5556000000,-83000000,1310000000,1300000000
1771,2020-09-30 00:00:00,The Travelers Companies,TRV,,986000000,827000000,1109000000,2182000000,1073000000,1073000000,-87000000,159000000,8275000000,7202000000,6093000000,-87000000,827000000,821000000
1772,2021-04-03 00:00:00,The Walt Disney Company,DIS,,1230000000,901000000,3149000000,5831000000,1410000000,1410000000,-415000000,108000000,15613000000,14203000000,9782000000,-180000000,1122000000,901000000
1773,2021-01-02 00:00:00,The Walt Disney Company,DIS,,46000000,17000000,2950000000,4474000000,226000000,226000000,-404000000,16000000,16249000000,16023000000,11775000000,-180000000,30000000,17000000
1774,2020-10-03 00:00:00,The Walt Disney Company,DIS,,-580000000,-710000000,2833000000,3694000000,-474000000,-474000000,-475000000,49000000,14707000000,15181000000,11013000000,-106000000,-629000000,-710000000
1775,2020-06-27 00:00:00,The Walt Disney Company,DIS,,-4840000000,-4721000000,2452000000,3883000000,54000000,54000000,-456000000,-331000000,11779000000,11725000000,7896000000,-4894000000,-4509000000,-4721000000
1776,2021-07-03 00:00:00,Thermo Fisher Scientific,TMO,343000000,2047000000,1828000000,1941000000,4524000000,2240000000,2240000000,-122000000,219000000,9273000000,7033000000,4749000000,-193000000,1828000000,1828000000
1777,2021-04-03 00:00:00,Thermo Fisher Scientific,TMO,320000000,2753000000,2337000000,1808000000,5217000000,3089000000,3089000000,-118000000,416000000,9906000000,6817000000,4689000000,-336000000,2337000000,2337000000
1778,2020-12-31 00:00:00,Thermo Fisher Scientific,TMO,376000000,2892000000,2498000000,2096000000,5557000000,3085000000,3085000000,-132000000,394000000,10550000000,7465000000,4993000000,-193000000,2498000000,2498000000
1779,2020-09-26 00:00:00,Thermo Fisher Scientific,TMO,296000000,2252000000,1933000000,1647000000,4332000000,2389000000,2389000000,-149000000,319000000,8521000000,6132000000,4189000000,-137000000,1933000000,1933000000
1780,2021-05-01 00:00:00,TJX Companies,TJX,,721346000,533930000,2064992000,2831026000,766034000,766034000,-45888000,187416000,10086661000,9320627000,7255635000,-44688000,533930000,533930000
1781,2021-01-30 00:00:00,TJX Companies,TJX,,508138000,325523000,5610468000,5966002000,355534000,355534000,-48854000,182615000,10943210000,10587676000,4977208000,152604000,325523000,325523000
1782,2020-10-31 00:00:00,TJX Companies,TJX,,1015992000,866656000,1986128000,3055004000,1068876000,1068876000,-54200000,149336000,10117289000,9048413000,7062285000,-52884000,866656000,866656000
1783,2020-08-01 00:00:00,TJX Companies,TJX,,-92019000,-214220000,1527768000,1493085000,-34683000,-34683000,-59000000,122201000,6667575000,6702258000,5174490000,-57336000,-214220000,-214220000
1784,2021-06-26 00:00:00,Tractor Supply Company,TSCO,,479182000,370022000,723749000,1287485000,498883000,498883000,-6701000,109160000,3601559000,3102676000,2314074000,-19701000,370022000,370022000
1785,2021-03-27 00:00:00,Tractor Supply Company,TSCO,,223315000,181354000,693190000,983780000,230536000,230536000,-7221000,41961000,2792336000,2561800000,1808556000,-7221000,181354000,181354000
1786,2020-12-26 00:00:00,Tractor Supply Company,TSCO,,176381000,135893000,643522000,995530000,293518000,293518000,-8086000,40488000,2878265000,2584747000,1882735000,-117137000,135893000,135893000
1787,2020-09-26 00:00:00,Tractor Supply Company,TSCO,,244969000,190610000,621129000,947957000,272177000,272177000,-7208000,54359000,2606572000,2334395000,1658615000,-27208000,190610000,190610000
1788,2021-06-30 00:00:00,Trane Technologies,TT,,592000000,464700000,617800000,1271500000,653700000,653700000,-59300000,122800000,3829700000,3176000000,2558200000,-61700000,469200000,464700000
1789,2021-03-31 00:00:00,Trane Technologies,TT,,285300000,235200000,597200000,955000000,357800000,357800000,-60700000,48400000,3017600000,2659800000,2062600000,-72500000,236900000,235200000
1790,2020-12-31 00:00:00,Trane Technologies,TT,,322600000,244700000,563400000,950100000,386700000,386700000,-61900000,72400000,3179100000,2792400000,2229000000,-64100000,250200000,244700000
1791,2020-09-30 00:00:00,Trane Technologies,TT,,500000000,400600000,566800000,1138000000,571200000,571200000,-62400000,89900000,3495500000,2924300000,2357500000,-71200000,410100000,400600000
1792,2021-07-03 00:00:00,TransDigm Group,TDG,,244000000,317000000,165000000,657000000,456000000,456000000,-263000000,-73000000,1218000000,762000000,561000000,-212000000,317000000,317000000
1793,2021-04-03 00:00:00,TransDigm Group,TDG,,130000000,104000000,148000000,615000000,431000000,431000000,-268000000,25000000,1194000000,763000000,579000000,-301000000,105000000,104000000
1794,2021-01-02 00:00:00,TransDigm Group,TDG,,53000000,50000000,185000000,554000000,340000000,340000000,-267000000,3000000,1108000000,768000000,554000000,-287000000,50000000,-23000000
1795,2020-09-30 00:00:00,TransDigm Group,TDG,,76000000,82000000,167000000,560000000,352000000,352000000,-267000000,-25000000,1173000000,821000000,613000000,-276000000,101000000,82000000
1796,2021-07-02 00:00:00,Trimble,TRMB,138300000,162400000,138900000,224800000,547600000,149500000,149500000,-16600000,23500000,945200000,795700000,397600000,12900000,138900000,138900000
1797,2021-04-02 00:00:00,Trimble,TRMB,129400000,137400000,114500000,207800000,515400000,142400000,142400000,-16900000,22800000,886500000,744100000,371100000,-5000000,114600000,114500000
1798,2021-01-01 00:00:00,Trimble,TRMB,125800000,128300000,180300000,180100000,491000000,147500000,147500000,-17900000,-52400000,829700000,682200000,338700000,-19200000,180700000,180300000
1799,2020-10-02 00:00:00,Trimble,TRMB,117900000,96400000,84700000,191000000,463300000,114400000,114400000,-19600000,11600000,792100000,677700000,328800000,-18000000,84800000,84700000
1800,2021-06-30 00:00:00,Truist Financial,TFC,,2073000000,1657000000,3211000000,6084000000,0,2543000000,,415000000,6084000000,3541000000,0,-470000000,1658000000,1559000000
1801,2021-03-31 00:00:00,Truist Financial,TFC,,1824000000,1477000000,3140000000,5434000000,0,2131000000,,351000000,5434000000,3303000000,0,-307000000,1473000000,1334000000
1802,2020-12-31 00:00:00,Truist Financial,TFC,,1641000000,1329000000,3156000000,5474000000,0,2153000000,,311000000,5474000000,3321000000,0,-512000000,1330000000,1228000000
1803,2020-09-30 00:00:00,Truist Financial,TFC,,1396000000,1138000000,3093000000,5151000000,0,1836000000,,255000000,5151000000,3315000000,0,-440000000,1141000000,1068000000
1804,2021-06-30 00:00:00,Twitter,TWTR,299859000,81300000,65649000,443384000,773495000,30252000,30252000,-13893000,15651000,1190427000,1160175000,416932000,51048000,65649000,65649000
1805,2021-03-31 00:00:00,Twitter,TWTR,250709000,50004000,68005000,352119000,655010000,52182000,52182000,-13185000,-18001000,1036018000,983836000,381008000,-2178000,68005000,68005000
1806,2020-12-31 00:00:00,Twitter,TWTR,247940000,224019000,222116000,206403000,856117000,401774000,401774000,-40166000,1903000,1289041000,887267000,432924000,-177755000,222116000,222116000
1807,2020-09-30 00:00:00,Twitter,TWTR,208877000,29683000,28659000,309861000,574845000,56107000,56107000,-39614000,1024000,936233000,880126000,361388000,-26424000,28659000,28659000
1808,2021-03-31 00:00:00,Tyler Technologies,TYL,21813000,38296000,36976000,77961000,144207000,39021000,39021000,-379000,1320000,294802000,255781000,150595000,-1104000,36976000,36976000
1809,2020-12-31 00:00:00,Tyler Technologies,TYL,22411000,48412000,54094000,62736000,138669000,48036000,48036000,-610000,-5682000,283285000,235249000,144616000,376000,54094000,54094000
1810,2020-09-30 00:00:00,Tyler Technologies,TYL,21642000,49936000,39284000,66819000,143509000,49656000,49656000,-610000,10652000,285746000,236090000,142237000,280000,39284000,39284000
1811,2020-06-30 00:00:00,Tyler Technologies,TYL,21949000,41811000,53892000,62521000,131203000,41341000,41341000,-610000,-12081000,271091000,229750000,139888000,470000,53892000,53892000
1812,2021-07-03 00:00:00,Tyson Foods,TSN,,966000000,749000000,562000000,1675000000,1113000000,1113000000,-105000000,213000000,12478000000,11365000000,10803000000,-147000000,753000000,749000000
1813,2021-04-03 00:00:00,Tyson Foods,TSN,,624000000,476000000,534000000,1348000000,814000000,814000000,-110000000,147000000,11300000000,10486000000,9952000000,-190000000,477000000,476000000
1814,2021-01-02 00:00:00,Tyson Foods,TSN,,616000000,467000000,475000000,1297000000,822000000,822000000,-110000000,144000000,10460000000,9638000000,9163000000,-206000000,472000000,467000000
1815,2020-10-03 00:00:00,Tyson Foods,TSN,,781000000,613000000,562000000,1807000000,1245000000,1245000000,-124000000,165000000,11460000000,10215000000,9653000000,-464000000,616000000,613000000
1816,2021-06-30 00:00:00,U.S. Bancorp,USB,,2539000000,1982000000,3018000000,5907000000,0,2579000000,,551000000,5907000000,3328000000,0,-40000000,1988000000,1914000000
1817,2021-03-31 00:00:00,U.S. Bancorp,USB,,2892000000,2280000000,3024000000,6237000000,0,2930000000,,607000000,6237000000,3307000000,0,-38000000,2285000000,2175000000
1818,2020-12-31 00:00:00,U.S. Bancorp,USB,,1920000000,1519000000,2878000000,5238000000,0,1739000000,,395000000,5238000000,3499000000,0,181000000,1525000000,1425000000
1819,2020-09-30 00:00:00,U.S. Bancorp,USB,,1933000000,1580000000,2876000000,5259000000,0,2026000000,,347000000,5259000000,3233000000,0,-93000000,1586000000,1494000000
1820,2021-07-31 00:00:00,Ulta Beauty,ULTA,,331882000,250893000,465347000,797963000,331259000,331259000,-425000,80989000,1967207000,1635948000,1169244000,623000,250893000,250893000
1821,2021-05-01 00:00:00,Ulta Beauty,ULTA,,304966000,230289000,446214000,753788000,302985000,302985000,-358000,74677000,1938519000,1635534000,1184731000,1981000,230289000,230289000
1822,2021-01-30 00:00:00,Ulta Beauty,ULTA,,223809000,171494000,847035000,1156328000,307075000,307075000,-463000,52315000,2198701000,1891626000,1042373000,-83266000,171494000,171494000
1823,2020-10-31 00:00:00,Ulta Beauty,ULTA,,99894000,74798000,416378000,545519000,124901000,124901000,-1383000,25096000,1552033000,1427132000,1006514000,-25007000,74798000,74798000
1824,2021-06-30 00:00:00,Under Armour (Class A),UAA,,69234000,59207000,545503000,669229000,123726000,123726000,-13307000,10027000,1351534000,1227808000,682305000,-54492000,59207000,59207000
1825,2021-03-31 00:00:00,Under Armour (Class A),UAA,,87633000,77752000,516138000,628641000,112503000,112503000,-14137000,9881000,1257195000,1144692000,628554000,-24870000,77752000,77752000
1826,2020-12-31 00:00:00,Under Armour (Class A),UAA,,219144000,184453000,581178000,705998000,117820000,117820000,-15008000,34691000,1403766000,1285946000,697768000,101324000,184453000,184453000
1827,2020-09-30 00:00:00,Under Armour (Class A),UAA,,35232000,38946000,555049000,686320000,131271000,131271000,-14955000,-3714000,1433021000,1301750000,746701000,-96039000,38946000,38946000
1828,2021-06-30 00:00:00,Under Armour (Class C),UA,,69234000,59207000,545503000,669229000,123726000,123726000,-13307000,10027000,1351534000,1227808000,682305000,-54492000,59207000,59207000
1829,2021-03-31 00:00:00,Under Armour (Class C),UA,,87633000,77752000,516138000,628641000,112503000,112503000,-14137000,9881000,1257195000,1144692000,628554000,-24870000,77752000,77752000
1830,2020-12-31 00:00:00,Under Armour (Class C),UA,,219144000,184453000,581178000,705998000,117820000,117820000,-15008000,34691000,1403766000,1285946000,697768000,101324000,184453000,184453000
1831,2020-09-30 00:00:00,Under Armour (Class C),UA,,35232000,38946000,555049000,686320000,131271000,131271000,-14955000,-3714000,1433021000,1301750000,746701000,-96039000,38946000,38946000
1832,2021-06-30 00:00:00,Union Pacific,UNP,,2316000000,1798000000,,3314000000,2480000000,2480000000,-282000000,518000000,5504000000,3024000000,2190000000,-164000000,1798000000,1798000000
1833,2021-03-31 00:00:00,Union Pacific,UNP,,1754000000,1341000000,,2868000000,1999000000,1999000000,-290000000,413000000,5001000000,3002000000,2133000000,-245000000,1341000000,1341000000
1834,2020-12-31 00:00:00,Union Pacific,UNP,,1793000000,1380000000,,3089000000,2019000000,2019000000,-279000000,413000000,5141000000,3122000000,2052000000,-226000000,1380000000,1380000000
1835,2020-09-30 00:00:00,Union Pacific,UNP,,1773000000,1363000000,,2897000000,2043000000,2043000000,-295000000,410000000,4919000000,2876000000,2022000000,-270000000,1363000000,1363000000
1836,2021-06-30 00:00:00,United Airlines,UAL,,-564000000,-434000000,139000000,512000000,-1204000000,-1204000000,-404000000,-130000000,5471000000,6675000000,4959000000,640000000,-434000000,-434000000
1837,2021-03-31 00:00:00,United Airlines,UAL,,-1751000000,-1357000000,85000000,-1402000000,-2984000000,-2984000000,-336000000,-394000000,3221000000,6205000000,4623000000,1233000000,-1357000000,-1357000000
1838,2020-12-31 00:00:00,United Airlines,UAL,,-2373000000,-1897000000,167000000,-917000000,-2452000000,-2452000000,-334000000,-476000000,3412000000,5864000000,4329000000,79000000,-1897000000,-1897000000
1839,2020-09-30 00:00:00,United Airlines,UAL,,-2332000000,-1841000000,53000000,-1334000000,-2692000000,-2692000000,-329000000,-491000000,2489000000,5181000000,3823000000,360000000,-1841000000,-1841000000
1840,2021-06-30 00:00:00,United Parcel Service,UPS,,3436000000,2676000000,,6094000000,3575000000,3575000000,-167000000,760000000,23424000000,19849000000,17330000000,-139000000,2676000000,2676000000
1841,2021-03-31 00:00:00,United Parcel Service,UPS,,6204000000,4792000000,,8970000000,6510000000,6510000000,-177000000,1412000000,22908000000,16398000000,13938000000,-306000000,4792000000,4792000000
1842,2020-12-31 00:00:00,United Parcel Service,UPS,,-4288000000,-3347000000,,-2065000000,-5499000000,-5499000000,-175000000,-941000000,24896000000,30395000000,26961000000,1211000000,-3347000000,-3347000000
1843,2020-09-30 00:00:00,United Parcel Service,UPS,,2525000000,1957000000,,5001000000,2748000000,2748000000,-176000000,568000000,21238000000,18490000000,16237000000,-223000000,1957000000,1957000000
1844,2021-06-30 00:00:00,United Rentals,URI,,377000000,293000000,301000000,884000000,493000000,493000000,-100000000,84000000,2287000000,1794000000,1403000000,-116000000,293000000,293000000
1845,2021-03-31 00:00:00,United Rentals,URI,,275000000,203000000,250000000,725000000,384000000,384000000,-99000000,72000000,2057000000,1673000000,1332000000,-109000000,203000000,203000000
1846,2020-12-31 00:00:00,United Rentals,URI,,387000000,297000000,258000000,884000000,530000000,530000000,-101000000,90000000,2279000000,1749000000,1395000000,-143000000,297000000,297000000
1847,2020-09-30 00:00:00,United Rentals,URI,,275000000,208000000,232000000,898000000,569000000,569000000,-119000000,67000000,2187000000,1618000000,1289000000,-294000000,208000000,208000000
1848,2021-06-30 00:00:00,UnitedHealth Group,UNH,,5568000000,4266000000,10359000000,17115000000,5978000000,5978000000,-410000000,1196000000,71321000000,65343000000,54206000000,-410000000,4372000000,4266000000
1849,2021-03-31 00:00:00,UnitedHealth Group,UNH,,6342000000,4862000000,10223000000,17720000000,6739000000,6739000000,-397000000,1364000000,70196000000,63457000000,52476000000,-397000000,4978000000,4862000000
1850,2020-12-31 00:00:00,UnitedHealth Group,UNH,,3116000000,2212000000,11514000000,15763000000,3517000000,3517000000,-401000000,764000000,65467000000,61950000000,49704000000,-401000000,2352000000,2212000000
1851,2020-09-30 00:00:00,UnitedHealth Group,UNH,,4256000000,3172000000,10174000000,15544000000,4651000000,4651000000,-395000000,1000000000,65115000000,60464000000,49571000000,-395000000,3256000000,3172000000
1852,2021-06-30 00:00:00,Universal Health Services,UHS,,426798000,325024000,29149000,1371912000,438968000,438968000,-21709000,101522000,3197880000,2758912000,1825968000,-12170000,325276000,324363000
1853,2021-03-31 00:00:00,Universal Health Services,UHS,,272877000,209091000,31324000,1168104000,295669000,295669000,-22861000,63807000,3012987000,2717318000,1844883000,-22792000,209070000,208539000
1854,2020-12-31 00:00:00,Universal Health Services,UHS,,402378000,308708000,31092000,1269541000,414959000,414959000,-21823000,94644000,3086935000,2671976000,1817394000,-12581000,307734000,307714000
1855,2020-09-30 00:00:00,Universal Health Services,UHS,,323264000,241279000,28488000,1170784000,349670000,349670000,-25095000,79172000,2912541000,2562871000,1741757000,-26406000,244092000,240489000
1856,2021-06-30 00:00:00,Valero Energy,VLO,,461000000,162000000,161000000,1285000000,524000000,524000000,-150000000,169000000,26326000000,25802000000,25041000000,-63000000,292000000,160000000
1857,2021-03-31 00:00:00,Valero Energy,VLO,,-770000000,-704000000,194000000,158000000,-652000000,-652000000,-149000000,-148000000,19686000000,20338000000,19528000000,-118000000,-622000000,-705000000
1858,2020-12-31 00:00:00,Valero Energy,VLO,,-598000000,-359000000,214000000,276000000,-460000000,-460000000,-153000000,-289000000,15298000000,15758000000,15022000000,-138000000,-309000000,-360000000
1859,2020-09-30 00:00:00,Valero Energy,VLO,,-716000000,-464000000,178000000,122000000,-583000000,-583000000,-143000000,-337000000,14470000000,15053000000,14348000000,-133000000,-379000000,-465000000
1860,2021-06-30 00:00:00,Ventas,VTR,,91929000,86391000,30588000,428582000,164294000,164294000,-110051000,3641000,923376000,759082000,494794000,-72365000,88288000,86391000
1861,2021-03-31 00:00:00,Ventas,VTR,,-53245000,-57209000,40309000,431384000,155427000,155427000,-110767000,2153000,909700000,754273000,478316000,-208672000,-55398000,-57209000
1862,2020-12-31 00:00:00,Ventas,VTR,,111274000,110451000,23411000,485269000,70392000,70392000,-114208000,-679000,938226000,867834000,452957000,40882000,111953000,110451000
1863,2020-09-30 00:00:00,Ventas,VTR,,10542000,12751000,34228000,418692000,135098000,135098000,-115505000,-3195000,919233000,784135000,500541000,-124556000,13737000,12751000
1864,2021-06-30 00:00:00,Verisign,VRSN,19808000,187874000,147772000,48822000,281609000,212979000,212979000,-23064000,40102000,329405000,116426000,47796000,-25105000,147772000,147772000
1865,2021-03-31 00:00:00,Verisign,VRSN,20311000,188317000,150354000,45935000,276653000,210407000,210407000,-22534000,37963000,323621000,113214000,46968000,-22090000,150354000,150354000
1866,2020-12-31 00:00:00,Verisign,VRSN,19403000,182896000,157314000,50401000,274312000,204508000,204508000,-22537000,25582000,320284000,115776000,45972000,-21612000,157314000,157314000
1867,2020-09-30 00:00:00,Verisign,VRSN,19708000,184887000,170979000,46498000,272855000,206649000,206649000,-22537000,13908000,317879000,111230000,45024000,-21762000,170979000,170979000
1868,2021-06-30 00:00:00,Verisk Analytics,VRSK,,235400000,154000000,113500000,482600000,265300000,265300000,-31500000,83800000,747500000,482200000,264900000,-29900000,151600000,154000000
1869,2021-03-31 00:00:00,Verisk Analytics,VRSK,,216700000,168600000,119300000,463700000,250900000,250900000,-35400000,48700000,726100000,475200000,262400000,-32500000,168000000,168600000
1870,2020-12-31 00:00:00,Verisk Analytics,VRSK,,216000000,176200000,107400000,452900000,252300000,252300000,-35300000,39800000,713400000,461100000,260500000,-36300000,176200000,176200000
1871,2020-09-30 00:00:00,Verisk Analytics,VRSK,,240000000,185800000,95900000,462700000,275900000,275900000,-35300000,54200000,702700000,426800000,240000000,-35900000,185800000,185800000
1872,2021-06-30 00:00:00,Verizon Communications,VZ,,7824000000,5800000000,6973000000,19509000000,8516000000,8516000000,-844000000,1875000000,33764000000,25248000000,14255000000,-692000000,5949000000,5800000000
1873,2021-03-31 00:00:00,Verizon Communications,VZ,,7078000000,5245000000,6822000000,19345000000,8349000000,8349000000,-1101000000,1700000000,32867000000,24518000000,13522000000,-1271000000,5378000000,5245000000
1874,2020-12-31 00:00:00,Verizon Communications,VZ,,6253000000,4588000000,7951000000,19870000000,7722000000,7722000000,-1080000000,1535000000,34692000000,26970000000,14822000000,-1469000000,4718000000,4588000000
1875,2020-09-30 00:00:00,Verizon Communications,VZ,,5851000000,4357000000,7043000000,19209000000,7974000000,7974000000,-1044000000,1347000000,31543000000,23569000000,12334000000,-2123000000,4504000000,4357000000
1876,2021-06-30 00:00:00,Vertex Pharmaceuticals,VRTX,,-44255000,66924000,194669000,158308000,-36361000,-36361000,-15478000,-111179000,1793370000,1829731000,1635062000,-7894000,66924000,66924000
1877,2021-03-31 00:00:00,Vertex Pharmaceuticals,VRTX,,820960000,653138000,192077000,1076003000,883926000,883926000,-15678000,167822000,1724305000,840379000,648302000,-62966000,653138000,653138000
1878,2020-12-31 00:00:00,Vertex Pharmaceuticals,VRTX,,888623000,604190000,211843000,958135000,746292000,746292000,-16288000,284433000,1627820000,881528000,669685000,142331000,604190000,604190000
1879,2020-09-30 00:00:00,Vertex Pharmaceuticals,VRTX,,745871000,667434000,184551000,858592000,674041000,674041000,-13856000,78437000,1538271000,864230000,679679000,71830000,667434000,667434000
1880,2021-07-03 00:00:00,VF Corporation,VFC,,179150000,324245000,1099034000,1240406000,141372000,141372000,-34917000,25178000,2194557000,2053185000,954151000,37778000,153972000,324245000
1881,2021-04-03 00:00:00,VF Corporation,VFC,,89049000,89520000,1155947000,1350573000,194626000,194626000,-37971000,27306000,2582672000,2388046000,1232099000,-105577000,61743000,89520000
1882,2020-12-26 00:00:00,VF Corporation,VFC,,386707000,347240000,1195245000,1649017000,453772000,453772000,-34315000,59048000,2971541000,2517769000,1322524000,-67065000,327659000,347240000
1883,2020-09-26 00:00:00,VF Corporation,VFC,,293661000,256722000,997960000,1329118000,331158000,331158000,-34107000,50415000,2608324000,2277166000,1279206000,-37497000,243246000,256722000
1884,2021-03-31 00:00:00,ViacomCBS,VIAC,,1137000000,911000000,1434000000,3049000000,1516000000,1516000000,-259000000,226000000,7412000000,5896000000,4363000000,-379000000,911000000,911000000
1885,2020-12-31 00:00:00,ViacomCBS,VIAC,,884000000,810000000,1399000000,2417000000,918000000,918000000,-268000000,158000000,6225000000,5307000000,3808000000,-34000000,726000000,810000000
1886,2020-09-30 00:00:00,ViacomCBS,VIAC,,662000000,615000000,1391000000,2482000000,992000000,992000000,-259000000,38000000,6116000000,5124000000,3634000000,-330000000,624000000,615000000
1887,2020-06-30 00:00:00,ViacomCBS,VIAC,,925000000,481000000,1240000000,2790000000,1451000000,1451000000,-263000000,202000000,6275000000,4824000000,3485000000,-526000000,723000000,481000000
1888,2021-06-30 00:00:00,Viatris,VTRS,143800000,-219100000,-279200000,981400000,1984100000,858900000,858900000,-167100000,60100000,4577800000,3718900000,2593700000,-1078000000,-279200000,-279200000
1889,2021-03-31 00:00:00,Viatris,VTRS,163000000,-441300000,-1037600000,968700000,1860700000,729000000,729000000,-169000000,596300000,4430300000,3701300000,2569600000,-1170300000,-1037600000,-1037600000
1890,2020-12-31 00:00:00,Viatris,VTRS,153300000,-1013500000,-915800000,1358700000,1361300000,-150700000,-150700000,-144400000,-97700000,3623500000,3774200000,2262200000,-862800000,-915800000,-915800000
1891,2020-09-30 00:00:00,Viatris,VTRS,126000000,241600000,185700000,615200000,1260200000,519000000,519000000,-117300000,55900000,2972100000,2453100000,1711900000,-277400000,185700000,185700000
1892,2021-06-30 00:00:00,Visa,V,,4389000000,2575000000,1678000000,5944000000,4062000000,4062000000,-131000000,1814000000,6130000000,2068000000,186000000,327000000,2575000000,2515000000
1893,2021-03-31 00:00:00,Visa,V,,3628000000,3026000000,1613000000,5550000000,3584000000,3584000000,-121000000,602000000,5729000000,2145000000,179000000,44000000,3026000000,2951000000
1894,2020-12-31 00:00:00,Visa,V,,3748000000,3126000000,1472000000,5514000000,3845000000,3845000000,-136000000,622000000,5687000000,1842000000,173000000,-97000000,3126000000,3038000000
1895,2020-09-30 00:00:00,Visa,V,,3055000000,2137000000,1537000000,4910000000,3177000000,3177000000,-168000000,918000000,5101000000,1924000000,191000000,-122000000,2137000000,2060000000
1896,2021-06-30 00:00:00,Vornado Realty Trust,VNO,,79673000,64512000,30602000,219447000,99068000,99068000,-51894000,2841000,410367000,311299000,190920000,-19395000,76832000,48036000
1897,2021-03-31 00:00:00,Vornado Realty Trust,VNO,,28977000,20550000,44186000,217228000,77688000,77688000,-50064000,1984000,409050000,331362000,191822000,-48711000,26993000,4074000
1898,2020-12-31 00:00:00,Vornado Realty Trust,VNO,,-210527000,-194979000,39122000,221255000,75049000,75049000,-54633000,-1801000,400998000,325949000,179743000,-285576000,-208726000,-209142000
1899,2020-09-30 00:00:00,Vornado Realty Trust,VNO,,92517000,65700000,32407000,194431000,55011000,55011000,-57371000,23781000,390076000,335065000,195645000,37506000,68736000,53155000
1900,2021-06-30 00:00:00,Vulcan Materials,VMC,,254063000,195344000,102338000,398364000,292854000,292854000,-41696000,57283000,1361047000,1068193000,962683000,-38791000,196780000,195344000
1901,2021-03-31 00:00:00,Vulcan Materials,VMC,,222308000,160614000,90264000,229267000,133877000,133877000,-33118000,60638000,1068344000,934467000,839077000,88431000,161670000,160614000
1902,2020-12-31 00:00:00,Vulcan Materials,VMC,,141188000,114518000,100205000,302741000,194071000,194071000,-35451000,25273000,1175119000,981048000,872378000,-52883000,115915000,114518000
1903,2020-09-30 00:00:00,Vulcan Materials,VMC,,258109000,199788000,85805000,380498000,292834000,292834000,-35782000,56984000,1309890000,1017056000,929392000,-34725000,201125000,199788000
1904,2021-06-30 00:00:00,W. R. Berkley Corporation,WRB,,299940000,237238000,11429000,985741000,344814000,344814000,-38096000,62262000,2296086000,1951272000,1310345000,-44874000,237678000,237238000
1905,2021-03-31 00:00:00,W. R. Berkley Corporation,WRB,,296068000,229525000,11264000,948987000,330742000,330742000,-36651000,64352000,2156869000,1826127000,1207882000,-34674000,231716000,229525000
1906,2020-12-31 00:00:00,W. R. Berkley Corporation,WRB,,399407000,312150000,11161000,1072320000,467718000,467718000,-35663000,86917000,2312471000,1844753000,1240151000,-68311000,312490000,312150000
1907,2020-09-30 00:00:00,W. R. Berkley Corporation,WRB,,206414000,151678000,11016000,840151000,251260000,251260000,-39768000,54048000,2039819000,1788559000,1199668000,-44846000,152366000,151678000
1908,2021-06-30 00:00:00,W. W. Grainger,GWW,,319000000,225000000,790000000,1124000000,334000000,334000000,-22000000,76000000,3207000000,2873000000,2083000000,-15000000,243000000,225000000
1909,2021-03-31 00:00:00,W. W. Grainger,GWW,,343000000,238000000,735000000,1093000000,358000000,358000000,-21000000,88000000,3084000000,2726000000,1991000000,-15000000,255000000,238000000
1910,2020-12-31 00:00:00,W. W. Grainger,GWW,,259000000,168000000,655000000,1027000000,312000000,312000000,-21000000,74000000,2941000000,2629000000,1914000000,-53000000,185000000,168000000
1911,2020-09-30 00:00:00,W. W. Grainger,GWW,,362000000,240000000,700000000,1074000000,374000000,374000000,-23000000,106000000,3018000000,2644000000,1944000000,-12000000,256000000,240000000
1912,2021-03-31 00:00:00,Wabtec,WAB,37700000,158200000,112400000,221700000,538200000,209300000,209300000,-47600000,43500000,1830200000,1620900000,1292000000,-51100000,114700000,112400000
1913,2020-12-31 00:00:00,Wabtec,WAB,38400000,118300000,87900000,232300000,526500000,185000000,185000000,-48600000,31500000,2023700000,1838700000,1497200000,-66700000,86800000,87700000
1914,2020-09-30 00:00:00,Wabtec,WAB,36500000,175400000,128100000,238200000,571200000,226200000,226200000,-45600000,46900000,1865100000,1638900000,1293900000,-50800000,128500000,127900000
1915,2020-06-30 00:00:00,Wabtec,WAB,38200000,114300000,86800000,187500000,503700000,205700000,205700000,-51400000,28500000,1737400000,1531700000,1233700000,-91400000,85800000,86600000
1916,2021-02-28 00:00:00,Walgreens Boots Alliance,WBA,,960000000,1026000000,5997000000,6781000000,784000000,784000000,-137000000,42000000,32779000000,31995000000,25998000000,176000000,918000000,1026000000
1917,2020-11-30 00:00:00,Walgreens Boots Alliance,WBA,,-593000000,-308000000,5820000000,6630000000,810000000,810000000,-164000000,-207000000,31438000000,30628000000,24808000000,-1403000000,-386000000,-308000000
1918,2020-08-31 00:00:00,Walgreens Boots Alliance,WBA,,565000000,373000000,6283000000,6803000000,520000000,520000000,-102000000,208000000,34746000000,34226000000,27943000000,45000000,357000000,373000000
1919,2020-05-31 00:00:00,Walgreens Boots Alliance,WBA,,-1766000000,-1708000000,6307000000,6438000000,131000000,131000000,-155000000,-40000000,34631000000,34500000000,28193000000,-1897000000,-1726000000,-1708000000
1920,2021-07-31 00:00:00,Walmart,WMT,,5923000000,4276000000,28511000000,35865000000,7354000000,7354000000,-515000000,1559000000,141048000000,133694000000,105183000000,-1431000000,4364000000,4276000000
1921,2021-04-30 00:00:00,Walmart,WMT,,3844000000,2730000000,28129000000,35038000000,6909000000,6909000000,-566000000,1033000000,138310000000,131401000000,103272000000,-3065000000,2811000000,2730000000
1922,2021-01-31 00:00:00,Walmart,WMT,,-593000000,-2091000000,30331000000,36818000000,6487000000,6487000000,-524000000,1415000000,152079000000,145592000000,115261000000,-7080000000,-2008000000,-2091000000
1923,2020-10-31 00:00:00,Walmart,WMT,,7115000000,5135000000,27991000000,34369000000,6378000000,6378000000,-541000000,1914000000,134708000000,128330000000,100339000000,737000000,5201000000,5135000000
1924,2021-06-30 00:00:00,Waste Management,WM,,456000000,351000000,445000000,1740000000,795000000,795000000,-98000000,105000000,4476000000,3681000000,2736000000,-339000000,351000000,351000000
1925,2021-03-31 00:00:00,Waste Management,WM,,545000000,421000000,458000000,1598000000,668000000,668000000,-97000000,124000000,4112000000,3444000000,2514000000,-123000000,421000000,421000000
1926,2020-12-31 00:00:00,Waste Management,WM,,547000000,438000000,360000000,1567000000,771000000,771000000,-97000000,109000000,4067000000,3296000000,2500000000,-224000000,438000000,438000000
1927,2020-09-30 00:00:00,Waste Management,WM,,516000000,390000000,416000000,1529000000,694000000,694000000,-97000000,126000000,3861000000,3167000000,2332000000,-178000000,390000000,390000000
1928,2021-07-03 00:00:00,Waters Corporation,WAT,44949000,197414000,167292000,158163000,401393000,196472000,196472000,-12027000,30122000,681647000,485175000,280254000,942000,167292000,167292000
1929,2021-04-03 00:00:00,Waters Corporation,WAT,38092000,173784000,148127000,143145000,354398000,171321000,171321000,-10946000,25657000,608545000,437224000,254147000,2463000,148127000,148127000
1930,2020-12-31 00:00:00,Waters Corporation,WAT,39662000,257251000,218311000,153179000,466089000,270561000,270561000,-11058000,38940000,786658000,516097000,320569000,-13310000,218311000,218311000
1931,2020-09-26 00:00:00,Waters Corporation,WAT,34971000,150437000,126769000,129625000,331442000,164189000,164189000,-10915000,23668000,593784000,429595000,262342000,-13752000,126769000,126769000
1932,2021-06-30 00:00:00,WEC Energy Group,WEC,,329500000,276000000,-21300000,686500000,390100000,390100000,-120300000,54100000,1676200000,1286100000,989700000,-60600000,275400000,276000000
1933,2021-03-31 00:00:00,WEC Energy Group,WEC,,584900000,510100000,-23300000,945900000,652600000,652600000,-119800000,74900000,2691400000,2038800000,1745500000,-67700000,510000000,510100000
1934,2020-12-31 00:00:00,WEC Energy Group,WEC,,276500000,239000000,1200000,689400000,387500000,387500000,-118200000,37200000,1933400000,1545900000,1244000000,-111000000,239300000,239000000
1935,2020-09-30 00:00:00,WEC Energy Group,WEC,,313700000,266800000,-11800000,669500000,382000000,382000000,-122300000,46900000,1651000000,1269000000,981500000,-68300000,266800000,266800000
1936,2021-06-30 00:00:00,Wells Fargo,WFC,,8189000000,6040000000,11950000000,21493000000,0,8227000000,,1445000000,21493000000,13266000000,0,-38000000,6744000000,5743000000
1937,2021-03-31 00:00:00,Wells Fargo,WFC,,5591000000,4636000000,12650000000,19580000000,0,5525000000,,901000000,19580000000,14055000000,0,66000000,4690000000,4256000000
1938,2020-12-31 00:00:00,Wells Fargo,WFC,,3302000000,2992000000,12641000000,18175000000,0,4083000000,,108000000,18175000000,14092000000,0,-781000000,3194000000,2642000000
1939,2020-09-30 00:00:00,Wells Fargo,WFC,,2864000000,2035000000,12461000000,18100000000,0,3589000000,,645000000,18100000000,14511000000,0,-725000000,2219000000,1720000000
1940,2021-06-30 00:00:00,Welltower,WELL,,43536000,26257000,31436000,490603000,218282000,218282000,-122341000,-2221000,1140992000,922710000,650389000,-174746000,45757000,26257000
1941,2021-03-31 00:00:00,Welltower,WELL,,76135000,71546000,29926000,412149000,137797000,137797000,-123142000,3943000,1052062000,914265000,639913000,-61662000,72192000,71546000
1942,2020-12-31 00:00:00,Welltower,WELL,,155568000,163729000,27848000,419534000,148953000,148953000,-121173000,290000,1122016000,973063000,702482000,6615000,155278000,163729000
1943,2020-09-30 00:00:00,Welltower,WELL,,396981000,325585000,31003000,417492000,130957000,130957000,-124851000,2003000,1036874000,905917000,619382000,266024000,394978000,325585000
1944,2021-06-30 00:00:00,West Pharmaceutical Services,WST,13800000,219600000,187300000,91400000,315100000,211400000,211400000,-1900000,32300000,723600000,512200000,408500000,8200000,187300000,187300000
1945,2021-03-31 00:00:00,West Pharmaceutical Services,WST,12200000,179900000,151200000,79200000,271900000,178300000,178300000,-1900000,28700000,670700000,492400000,398800000,1600000,151200000,151200000
1946,2020-12-31 00:00:00,West Pharmaceutical Services,WST,12900000,118800000,98400000,75300000,211100000,121000000,121000000,-2100000,20400000,580200000,459200000,369100000,-2200000,98400000,98400000
1947,2020-09-30 00:00:00,West Pharmaceutical Services,WST,12500000,103400000,82300000,75900000,194600000,106700000,106700000,-2100000,21100000,548000000,441300000,353400000,-3300000,82300000,82300000
1948,2021-04-02 00:00:00,Western Digital,WDC,555000000,249000000,197000000,287000000,1124000000,282000000,282000000,-81000000,52000000,4137000000,3855000000,3013000000,-33000000,197000000,197000000
1949,2021-01-01 00:00:00,Western Digital,WDC,535000000,85000000,62000000,265000000,960000000,160000000,160000000,-81000000,23000000,3943000000,3783000000,2983000000,-75000000,62000000,62000000
1950,2020-10-02 00:00:00,Western Digital,WDC,555000000,-3000000,-60000000,256000000,874000000,63000000,63000000,-84000000,57000000,3922000000,3859000000,3048000000,-66000000,-60000000,-60000000
1951,2020-07-03 00:00:00,Western Digital,WDC,546000000,185000000,148000000,268000000,1002000000,188000000,188000000,-87000000,37000000,4287000000,4099000000,3285000000,-3000000,148000000,148000000
1952,2021-06-30 00:00:00,Western Union,WU,,260100000,222500000,282800000,534700000,251900000,251900000,-25600000,37600000,1289700000,1037800000,755000000,8200000,222500000,222500000
1953,2021-03-31 00:00:00,Western Union,WU,,202900000,181800000,274300000,504000000,229700000,229700000,-28400000,21100000,1210000000,980300000,706000000,-26800000,181800000,181800000
1954,2020-12-31 00:00:00,Western Union,WU,,199000000,177100000,278600000,514600000,236000000,236000000,-28100000,21900000,1271800000,1035800000,757200000,-37000000,177100000,177100000
1955,2020-09-30 00:00:00,Western Union,WU,,261000000,228600000,246200000,537600000,291400000,291400000,-28200000,32400000,1258500000,967100000,720900000,-30400000,228600000,228600000
1956,2021-03-31 00:00:00,WestRock,WRK,,144900000,112500000,423400000,749600000,237600000,237600000,-94900000,30500000,4437800000,4200200000,3688200000,-92700000,114400000,112400000
1957,2020-12-31 00:00:00,WestRock,WRK,,202800000,152000000,382900000,752300000,277500000,277500000,-105500000,50300000,4401500000,4124000000,3649200000,-74700000,152500000,152000000
1958,2020-09-30 00:00:00,WestRock,WRK,,-1114500000,-1156000000,365100000,873000000,408900000,408900000,-164700000,40000000,4471500000,4062600000,3598500000,-1523400000,-1154500000,-1156000000
1959,2020-06-30 00:00:00,WestRock,WRK,,199200000,178500000,364500000,765800000,301700000,301700000,-98400000,19200000,4236300000,3934600000,3470500000,-102500000,180000000,178500000
1960,2021-06-30 00:00:00,Weyerhaeuser,WY,,1352000000,1028000000,120000000,1561000000,1432000000,1432000000,-78000000,324000000,3144000000,1712000000,1583000000,-80000000,1028000000,1028000000
1961,2021-03-31 00:00:00,Weyerhaeuser,WY,,870000000,681000000,118000000,1076000000,953000000,953000000,-79000000,189000000,2506000000,1553000000,1430000000,-83000000,681000000,681000000
1962,2020-12-31 00:00:00,Weyerhaeuser,WY,,311000000,292000000,123000000,671000000,529000000,529000000,-144000000,19000000,2063000000,1534000000,1392000000,-218000000,292000000,292000000
1963,2020-09-30 00:00:00,Weyerhaeuser,WY,,392000000,283000000,127000000,720000000,586000000,586000000,-111000000,109000000,2110000000,1524000000,1390000000,-194000000,283000000,283000000
1964,2021-06-30 00:00:00,Whirlpool Corporation,WHR,,674000000,581000000,499000000,1090000000,581000000,581000000,-45000000,94000000,5324000000,4743000000,4234000000,93000000,580000000,581000000
1965,2021-03-31 00:00:00,Whirlpool Corporation,WHR,,599000000,433000000,490000000,1148000000,641000000,641000000,-45000000,159000000,5358000000,4717000000,4210000000,-42000000,440000000,433000000
1966,2020-12-31 00:00:00,Whirlpool Corporation,WHR,,652000000,497000000,556000000,1364000000,792000000,792000000,-47000000,151000000,5798000000,5006000000,4434000000,-140000000,501000000,497000000
1967,2020-09-30 00:00:00,Whirlpool Corporation,WHR,,541000000,397000000,501000000,1155000000,638000000,638000000,-51000000,143000000,5291000000,4653000000,4136000000,-97000000,398000000,397000000
1968,2021-06-30 00:00:00,Williams Companies,WMB,,441000000,304000000,113000000,1189000000,601000000,601000000,-298000000,119000000,2283000000,1682000000,1094000000,-160000000,322000000,304000000
1969,2021-03-31 00:00:00,Williams Companies,WMB,,576000000,426000000,123000000,1299000000,739000000,739000000,-294000000,141000000,2612000000,1873000000,1313000000,-163000000,435000000,425000000
1970,2020-12-31 00:00:00,Williams Companies,WMB,,185000000,116000000,112000000,1242000000,700000000,700000000,-290000000,55000000,2092000000,1392000000,850000000,-515000000,130000000,115000000
1971,2020-09-30 00:00:00,Williams Companies,WMB,,434000000,309000000,115000000,1196000000,640000000,640000000,-292000000,111000000,1933000000,1293000000,737000000,-206000000,323000000,308000000
1972,2021-03-31 00:00:00,Willis Towers Watson,WLTW,,832000000,733000000,59000000,1143000000,552000000,552000000,-59000000,96000000,2590000000,2038000000,1447000000,280000000,736000000,733000000
1973,2020-12-31 00:00:00,Willis Towers Watson,WLTW,,602000000,476000000,59000000,1422000000,798000000,798000000,-60000000,119000000,2764000000,1966000000,1342000000,-196000000,483000000,476000000
1974,2020-09-30 00:00:00,Willis Towers Watson,WLTW,,168000000,121000000,60000000,754000000,191000000,191000000,-61000000,46000000,2009000000,1818000000,1255000000,-23000000,122000000,121000000
1975,2020-06-30 00:00:00,Willis Towers Watson,WLTW,,177000000,94000000,59000000,822000000,249000000,249000000,-62000000,75000000,2113000000,1864000000,1291000000,-72000000,102000000,94000000
1976,2021-06-30 00:00:00,Wynn Resorts,WYNN,,-172700000,-131369000,197545000,594118000,-25921000,-25921000,-150424000,697000,990113000,1016034000,395995000,-146779000,-173397000,-131369000
1977,2021-03-31 00:00:00,Wynn Resorts,WYNN,,-335686000,-280978000,179774000,418774000,-172632000,-172632000,-152852000,493000,736682000,909314000,317908000,-163054000,-336179000,-280978000
1978,2020-12-31 00:00:00,Wynn Resorts,WYNN,,-309723000,-269502000,173544000,402410000,-119911000,-119911000,-149287000,568000,685995000,805906000,283585000,-189812000,-310291000,-269502000
1979,2020-09-30 00:00:00,Wynn Resorts,WYNN,,-424168000,-758142000,160896000,149845000,-275707000,-275707000,-145142000,407365000,370452000,646159000,220607000,-148461000,-831533000,-758142000
1980,2021-09-30 00:00:00,Xcel Energy,XEL,,652000000,609000000,56000000,1570000000,825000000,825000000,-211000000,43000000,3467000000,2642000000,1897000000,-173000000,609000000,609000000
1981,2021-06-30 00:00:00,Xcel Energy,XEL,,273000000,311000000,55000000,1179000000,439000000,439000000,-212000000,-38000000,3068000000,2629000000,1889000000,-166000000,311000000,311000000
1982,2021-03-31 00:00:00,Xcel Energy,XEL,,340000000,362000000,58000000,1249000000,507000000,507000000,-205000000,-22000000,3541000000,3034000000,2292000000,-167000000,362000000,362000000
1983,2020-12-31 00:00:00,Xcel Energy,XEL,,258000000,288000000,241000000,1322000000,423000000,423000000,-212000000,-30000000,2947000000,2524000000,1625000000,-165000000,288000000,288000000
1984,2021-07-03 00:00:00,Xilinx,XLNX,247975000,211363000,206341000,124920000,595165000,210363000,210363000,-10276000,5022000,878606000,668243000,283441000,1000000,206341000,206341000
1985,2021-04-03 00:00:00,Xilinx,XLNX,239863000,195536000,187883000,127872000,578136000,199782000,199782000,-13578000,7653000,850987000,651205000,272851000,-4246000,187883000,187883000
1986,2021-01-02 00:00:00,Xilinx,XLNX,235018000,176134000,170972000,136701000,553875000,172425000,172425000,-14228000,5162000,803404000,630979000,249529000,3709000,170972000,170972000
1987,2020-09-26 00:00:00,Xilinx,XLNX,219647000,194646000,193816000,113793000,548415000,205417000,205417000,-14226000,830000,766535000,561118000,218120000,-10771000,193816000,193816000
1988,2021-06-30 00:00:00,Xylem,XYL,53000000,138000000,113000000,309000000,520000000,158000000,158000000,-21000000,25000000,1351000000,1193000000,831000000,-20000000,113000000,113000000
1989,2021-03-31 00:00:00,Xylem,XYL,50000000,114000000,87000000,304000000,490000000,136000000,136000000,-21000000,27000000,1256000000,1120000000,766000000,-22000000,87000000,87000000
1990,2020-12-31 00:00:00,Xylem,XYL,49000000,158000000,148000000,296000000,532000000,187000000,187000000,-21000000,10000000,1373000000,1186000000,841000000,-29000000,148000000,148000000
1991,2020-09-30 00:00:00,Xylem,XYL,45000000,50000000,37000000,269000000,461000000,147000000,147000000,-22000000,13000000,1220000000,1073000000,759000000,-97000000,37000000,37000000
1992,2021-06-30 00:00:00,Yum! Brands,YUM,,407000000,391000000,231000000,786000000,560000000,560000000,-125000000,16000000,1602000000,1042000000,816000000,-153000000,391000000,391000000
1993,2021-03-31 00:00:00,Yum! Brands,YUM,,409000000,326000000,209000000,728000000,532000000,532000000,-119000000,83000000,1486000000,954000000,758000000,-123000000,326000000,326000000
1994,2020-12-31 00:00:00,Yum! Brands,YUM,,352000000,332000000,331000000,823000000,496000000,496000000,-147000000,20000000,1743000000,1247000000,920000000,-144000000,332000000,332000000
1995,2020-09-30 00:00:00,Yum! Brands,YUM,,316000000,283000000,228000000,723000000,502000000,502000000,-161000000,33000000,1448000000,946000000,725000000,-186000000,283000000,283000000
1996,2021-07-03 00:00:00,Zebra Technologies,ZBRA,141000000,238000000,219000000,240000000,658000000,251000000,251000000,-7000000,19000000,1377000000,1126000000,719000000,-13000000,219000000,219000000
1997,2021-04-03 00:00:00,Zebra Technologies,ZBRA,140000000,276000000,228000000,216000000,655000000,273000000,273000000,-7000000,48000000,1347000000,1074000000,692000000,3000000,228000000,228000000
1998,2020-12-31 00:00:00,Zebra Technologies,ZBRA,137000000,216000000,199000000,218000000,618000000,237000000,237000000,-7000000,17000000,1308000000,1071000000,690000000,-21000000,199000000,199000000
1999,2020-09-26 00:00:00,Zebra Technologies,ZBRA,113000000,138000000,116000000,190000000,493000000,170000000,170000000,-10000000,22000000,1132000000,962000000,639000000,-32000000,116000000,116000000
2000,2021-06-30 00:00:00,Zimmer Biomet,ZBH,180500000,173900000,141900000,812000000,1453200000,306100000,306100000,-54700000,31400000,2026900000,1720800000,573700000,-132200000,142500000,141900000
2001,2021-03-31 00:00:00,Zimmer Biomet,ZBH,94400000,220600000,198100000,765500000,1331000000,315600000,315600000,-52300000,22900000,1847400000,1531800000,516400000,-95000000,197700000,198100000
2002,2020-12-31 00:00:00,Zimmer Biomet,ZBH,100000000,195600000,333700000,807200000,1433700000,373900000,373900000,-53100000,-138200000,2085300000,1711400000,651600000,-178300000,333800000,333700000
2003,2020-09-30 00:00:00,Zimmer Biomet,ZBH,85900000,255800000,242500000,772300000,1362200000,354300000,354300000,-54000000,9700000,1929300000,1575000000,567100000,-98500000,246100000,242500000
2004,2021-06-30 00:00:00,Zions Bancorp,ZION,,455000000,354000000,358000000,883000000,0,461000000,,101000000,883000000,422000000,0,-6000000,354000000,340000000
2005,2021-03-31 00:00:00,Zions Bancorp,ZION,,411000000,322000000,378000000,837000000,0,418000000,,89000000,837000000,419000000,0,-7000000,322000000,312000000
2006,2020-12-31 00:00:00,Zions Bancorp,ZION,,359000000,284000000,363000000,778000000,0,396000000,,75000000,778000000,382000000,0,-37000000,284000000,272000000
2007,2020-09-30 00:00:00,Zions Bancorp,ZION,,215000000,175000000,353000000,667000000,0,222000000,,40000000,667000000,445000000,0,-7000000,175000000,166000000
2008,2021-06-30 00:00:00,Zoetis,ZTS,120000000,636000000,512000000,495000000,1382000000,726000000,726000000,-57000000,125000000,1948000000,1222000000,566000000,-90000000,511000000,512000000
2009,2021-03-31 00:00:00,Zoetis,ZTS,118000000,687000000,559000000,409000000,1323000000,756000000,756000000,-57000000,129000000,1871000000,1115000000,548000000,-69000000,558000000,559000000
2010,2020-12-31 00:00:00,Zoetis,ZTS,133000000,420000000,359000000,518000000,1221000000,530000000,530000000,-58000000,62000000,1807000000,1277000000,586000000,-110000000,358000000,359000000
2011,2020-09-30 00:00:00,Zoetis,ZTS,112000000,597000000,479000000,419000000,1241000000,670000000,670000000,-62000000,118000000,1786000000,1116000000,545000000,-73000000,479000000,479000000
,,Meta Platforms,META,,,,,,,,,,,,,,,
,,Facebook,META,,,,,,,,,,,,,,,
